1.1.1,_,0
2.1.2,1.1.1,1
3.1.3,2.1.2,1
4.1.4,3.1.3,1
5.1.5,4.1.4,1
6.1.6,5.1.5,1
7.1.7,6.1.6,1
7.2.8,6.2.7,1
8.1.9,7.1.8,1
9.1.10,8.1.9,1
9.2.11,8.2.10,1
10.1.12,9.1.11,1
11.1.13,10.1.12,1
11.2.14,10.2.13,1
12.1.15,11.1.14,1
13.1.16,12.1.15,1
13.2.17,12.2.16,1
13.3.18,12.3.17,1
13.4.19,12.4.18,1
13.5.20,12.5.19,1
13.6.21,12.6.20,1
13.7.22,12.7.21,1
14.1.23,13.1.22,1
15.1.24,14.1.23,1
