_,1.1.1,0
1.1.1,_,0
1.2.2,_,0
1.3.3,_,0
1.4.4,_,0
1.5.5,_,0
2.1.6,2.1.2,1
3.1.7,3.1.3,1
4.1.8,4.1.4,1
5.1.9,5.1.5,1
6.1.10,6.1.6,1
7.1.11,7.1.7,1
7.2.12,7.2.8,1
8.1.13,8.1.9,1
9.1.14,9.1.10,0.9930769
10.1.15,10.1.11,1
10.2.16,10.2.12,1
10.3.17,10.3.13,1
10.4.18,10.4.14,1
10.5.19,10.5.15,1
10.6.20,10.6.16,1
10.7.21,10.7.17,1
11.1.22,11.1.18,0.9930233
12.1.23,12.1.19,1
13.1.24,13.1.20,1
14.1.25,14.1.21,1
14.2.26,14.2.22,1
14.3.27,14.3.23,1
14.4.28,14.4.24,1
14.5.29,14.5.25,1
