1.1.1,1.1.1,1
1.2.2,1.2.2,1
1.3.3,1.3.3,1
1.4.4,1.4.4,1
1.5.5,1.5.5,1
2.1.6,2.1.6,1
3.1.7,3.1.7,1
4.1.8,4.1.8,1
5.1.9,5.1.9,1
5.2.10,5.2.10,1
6.1.11,6.1.11,1
7.1.12,7.1.12,1
7.2.13,7.2.13,1
7.3.14,7.3.14,1
7.4.15,7.4.15,1
7.5.16,7.5.16,1
7.6.17,7.6.17,1
7.7.18,7.7.18,1
7.8.19,7.8.19,1
8.1.20,8.1.20,0.9684211
8.2.21,8.2.21,1
9.1.22,9.1.22,1
9.2.23,9.2.23,1
10.1.24,10.1.24,1
10.2.25,10.2.25,1
11.1.26,11.1.26,1
12.1.27,12.1.27,1
13.1.28,13.1.28,1
13.2.29,13.2.29,1
14.1.30,14.1.30,1
14.2.31,14.2.31,1
14.3.32,14.3.32,1
14.4.33,14.4.33,1
14.5.34,14.5.34,1
14.6.35,14.6.35,1
14.7.36,14.7.36,1
14.8.37,14.8.37,1
14.9.38,14.9.38,1
14.10.39,14.10.39,1
14.11.40,14.11.40,1
14.12.41,14.12.41,1
14.13.42,14.13.42,1
14.14.43,14.14.43,1
15.1.44,15.1.44,1
15.2.45,15.2.45,1
16.1.46,16.1.46,1
16.2.47,16.2.47,1
