1.1.1,1.1.1,1
2.1.2,2.1.2,1
3.1.3,3.1.3,1
4.1.4,4.1.4,1
5.1.5,5.1.5,1
6.1.6,6.1.6,1
7.1.7,7.1.7,1
7.2.8,7.2.8,1
7.3.9,7.3.9,1
7.4.10,7.4.10,1
8.1.11,8.1.11,1
9.1.12,9.1.12,1
9.2.13,9.2.13,1
10.1.14,10.1.14,1
11.1.15,11.1.15,1
12.1.16,12.1.16,1
12.2.17,12.2.17,1
12.3.18,12.3.18,1
12.4.19,12.4.19,1
12.5.20,12.5.20,1
12.6.21,12.6.21,1
13.1.22,13.1.22,1
14.1.23,14.1.23,1
15.1.24,15.1.24,1
15.2.25,15.2.25,1
15.3.26,15.3.26,1
15.4.27,15.4.27,1
15.5.28,15.5.28,1
16.1.29,16.1.29,1
17.1.30,17.1.30,1
18.1.31,18.1.31,1
19.1.32,19.1.32,1
19.2.33,19.2.33,1
19.3.34,19.3.34,1
19.4.35,19.4.35,1
19.5.36,19.5.36,1
19.6.37,19.6.37,1
19.7.38,19.7.38,1
19.8.39,19.8.39,1
