_,1.1.1,0
1.1.1,_,0
1.2.2,_,0
1.3.3,_,0
1.4.4,_,0
1.5.5,_,0
2.1.6,2.1.2,1
3.1.7,3.1.3,1
4.1.8,4.1.4,1
4.2.9,4.2.5,1
5.1.10,5.1.6,1
6.1.11,6.1.7,1
6.2.12,6.2.8,1
7.1.13,7.1.9,1
7.2.14,7.2.10,1
8.1.15,8.1.11,1
8.2.16,8.2.12,1
9.1.17,9.1.13,1
10.1.18,10.1.14,1
10.2.19,10.2.15,1
11.1.20,11.1.16,1
12.1.21,12.1.17,1
12.2.22,12.2.18,1
13.1.23,13.1.19,1
13.2.24,13.2.20,1
14.1.25,14.1.21,1
14.2.26,14.2.22,1
15.1.27,15.1.23,1
16.1.28,16.1.24,1
16.2.29,16.2.25,1
16.3.30,16.3.26,1
16.4.31,16.4.27,1
16.5.32,16.5.28,1
17.1.33,17.1.29,1
17.2.34,17.2.30,1
17.3.35,17.3.31,1
18.1.36,18.1.32,1
18.2.37,18.2.33,1
19.1.38,19.1.34,1
19.2.39,19.2.35,1
