_,1.1.1,0
1.1.1,_,0
1.2.2,_,0
1.3.3,_,0
1.4.4,_,0
1.5.5,_,0
2.1.6,2.1.2,1
3.1.7,3.1.3,1
4.1.8,4.1.4,1
5.1.9,5.1.5,1
6.1.10,6.1.6,1
7.1.11,7.1.7,1
7.2.12,7.2.8,1
7.3.13,7.3.9,1
7.4.14,7.4.10,1
8.1.15,8.1.11,1
9.1.16,9.1.12,1
9.2.17,9.2.13,1
9.3.18,9.3.14,1
9.4.19,9.4.15,1
10.1.20,10.1.16,1
11.1.21,11.1.17,1
12.1.22,12.1.18,1
12.2.23,12.2.19,1
12.3.24,12.3.20,1
12.4.25,12.4.21,1
12.5.26,12.5.22,1
12.6.27,12.6.23,1
13.1.28,13.1.24,1
14.1.29,14.1.25,1
15.1.30,15.1.26,1
15.2.31,15.2.27,1
15.3.32,15.3.28,1
15.4.33,15.4.29,1
15.5.34,15.5.30,1
16.1.35,16.1.31,1
17.1.36,17.1.32,1
18.1.37,18.1.33,1
19.1.38,19.1.34,1
19.2.39,19.2.35,1
19.3.40,19.3.36,1
19.4.41,19.4.37,1
19.5.42,19.5.38,1
19.6.43,19.6.39,1
19.7.44,19.7.40,1
19.8.45,19.8.41,1
