_,1.1.1,0
1.1.1,_,0
1.2.2,_,0
1.3.3,_,0
1.4.4,_,0
1.5.5,_,0
2.1.6,2.1.2,1
3.1.7,3.1.3,1
4.1.8,4.1.4,1
5.1.9,5.1.5,1
5.2.10,5.2.6,1
6.1.11,6.1.7,1
6.2.12,6.2.8,1
6.3.13,6.3.9,1
7.1.14,7.1.10,1
8.1.15,8.1.11,1
8.2.16,8.2.12,1
9.1.17,9.1.13,1
10.1.18,10.1.14,1
10.2.19,10.2.15,1
10.3.20,10.3.16,1
10.4.21,10.4.17,1
10.5.22,10.5.18,1
11.1.23,11.1.19,1
12.1.24,12.1.20,1
12.2.25,12.2.21,1
13.1.26,13.1.22,1
14.1.27,14.1.23,1
15.1.28,15.1.24,1
16.1.29,16.1.25,1
16.2.30,16.2.26,1
16.3.31,16.3.27,1
17.1.32,17.1.28,1
17.2.33,17.2.29,1
17.3.34,17.3.30,1
17.4.35,17.4.31,1
17.5.36,17.5.32,1
18.1.37,18.1.33,1
18.2.38,18.2.34,1
18.3.39,18.3.35,1
