1.1.1,1.1.1,1
2.1.2,2.1.2,1
3.1.3,3.1.3,1
4.1.4,4.1.4,1
5.1.5,5.1.5,1
5.2.6,5.2.6,1
5.3.7,5.3.7,1
5.4.8,5.4.8,1
6.1.9,6.1.9,1
7.1.10,7.1.10,1
7.2.11,7.2.11,1
7.3.12,7.3.12,1
7.4.13,7.4.13,1
7.5.14,7.5.14,1
7.6.15,7.6.15,1
7.7.16,7.7.16,1
7.8.17,7.8.17,1
8.1.18,8.1.18,1
9.1.19,9.1.19,1
9.2.20,9.2.20,1
9.3.21,9.3.21,1
9.4.22,9.4.22,1
10.1.23,10.1.23,1
11.1.24,11.1.24,1
12.1.25,12.1.25,1
12.2.26,12.2.26,1
12.3.27,12.3.27,1
12.4.28,12.4.28,1
13.1.29,13.1.29,1
14.1.30,14.1.30,1
14.2.31,14.2.31,1
14.3.32,14.3.32,1
14.4.33,14.4.33,1
14.5.34,14.5.34,1
14.6.35,14.6.35,1
14.7.36,14.7.36,1
14.8.37,14.8.37,1
14.9.38,14.9.38,1
14.10.39,14.10.39,1
14.11.40,14.11.40,1
14.12.41,14.12.41,1
14.13.42,14.13.42,1
14.14.43,14.14.43,1
14.15.44,14.15.44,1
14.16.45,14.16.45,1
14.17.46,14.17.46,1
14.18.47,14.18.47,1
15.1.48,15.1.48,1
