1.1.1,1.1.1,1
2.1.2,2.1.2,1
3.1.3,3.1.3,1
4.1.4,4.1.4,1
5.1.5,5.1.5,1
6.1.6,6.1.6,1
7.1.7,7.1.7,1
8.1.8,8.1.8,1
8.2.9,8.2.9,1
8.3.10,8.3.10,1
8.4.11,8.4.11,1
8.5.12,8.5.12,1
8.6.13,8.6.13,1
8.7.14,8.7.14,1
9.1.15,9.1.15,1
10.1.16,10.1.16,1
11.1.17,11.1.17,1
12.1.18,12.1.18,1
12.2.19,12.2.19,1
12.3.20,12.3.20,0.9704919
13.1.21,13.1.21,1
14.1.22,14.1.22,1
15.1.23,15.1.23,1
15.2.24,15.2.24,1
16.1.25,16.1.25,1
17.1.26,17.1.26,1
17.2.27,17.2.27,1
17.3.28,17.3.28,1
17.4.29,17.4.29,1
17.5.30,17.5.30,1
17.6.31,17.6.31,1
17.7.32,17.7.32,1
17.8.33,17.8.33,1
