1.1.1,1.1.1,1
2.1.2,2.1.2,0.7870968
3.1.3,3.1.3,1
4.1.4,4.1.4,1
5.1.5,5.1.5,1
6.1.6,6.1.6,1
6.2.7,6.2.7,1
7.1.8,7.1.8,1
8.1.9,8.1.9,0.9606491
8.2.10,8.2.10,1
8.3.11,8.3.11,0.93418807
8.4.12,8.4.12,0.93572676
8.5.13,8.5.13,0.8814526
9.1.14,9.1.14,1
10.1.15,10.1.15,1
11.1.16,11.1.16,1
12.1.17,12.1.17,0.9354117
13.1.18,13.1.18,1
14.1.19,14.1.19,1
15.1.20,15.1.20,0.7608121
16.1.21,16.1.21,1
16.2.22,16.2.22,1
16.3.23,16.3.23,1
16.4.24,16.4.24,1
16.5.25,16.5.25,1
16.6.26,16.6.26,1
16.7.27,16.7.27,1
16.8.28,16.8.28,1
16.9.29,16.9.29,1
