1.1.1,1.1.1,1
2.1.2,2.1.2,0.94490635
3.1.3,3.1.3,0.85716724
4.1.4,4.1.4,1
5.1.5,5.1.5,1
6.1.6,6.1.6,1
7.1.7,7.1.7,1
8.1.8,8.1.8,1
8.2.9,8.2.9,1
9.1.10,9.1.10,0.8666667
10.1.11,10.1.11,1
11.1.12,11.1.12,1
11.2.13,11.2.13,1
11.3.14,11.3.14,1
11.4.15,11.4.15,1
11.5.16,11.5.16,1
11.6.17,11.6.17,1
11.7.18,11.7.18,1
11.8.19,11.8.19,1
11.9.20,11.9.20,1
12.1.21,12.1.21,1
13.1.22,13.1.22,0.8956522
14.1.23,14.1.23,1
14.2.24,14.2.24,1
14.3.25,14.3.25,1
