_,1.1.1,0
1.1.1,_,0
2.1.2,2.1.2,1
3.1.3,3.1.3,1
4.1.4,4.1.4,1
5.1.5,5.1.5,1
6.1.6,6.1.6,1
7.1.7,7.1.7,1
7.2.8,7.2.8,1
8.1.9,8.1.9,1
9.1.10,9.1.10,1
10.1.11,10.1.11,1
10.2.12,10.2.12,1
10.3.13,10.3.13,1
10.4.14,10.4.14,1
10.5.15,10.5.15,1
10.6.16,10.6.16,1
10.7.17,10.7.17,1
11.1.18,11.1.18,1
12.1.19,12.1.19,1
13.1.20,13.1.20,1
14.1.21,14.1.21,1
14.2.22,14.2.22,1
14.3.23,14.3.23,1
14.4.24,14.4.24,1
14.5.25,14.5.25,1
