_,1.1.1,0
1.1.1,_,0
2.1.2,2.1.2,1
3.1.3,3.1.3,1
4.1.4,4.1.4,1
5.1.5,5.1.5,1
6.1.6,6.1.6,1
7.1.7,7.1.7,1
8.1.8,8.1.8,1
8.2.9,8.2.9,1
9.1.10,9.1.10,1
10.1.11,10.1.11,1
10.2.12,10.2.12,1
10.3.13,10.3.13,1
10.4.14,10.4.14,1
10.5.15,10.5.15,1
11.1.16,11.1.16,1
12.1.17,12.1.17,1
13.1.18,13.1.18,1
14.1.19,14.1.19,1
15.1.20,15.1.20,1
16.1.21,16.1.21,1
17.1.22,17.1.22,1
18.1.23,18.1.23,1
18.2.24,18.2.24,1
18.3.25,18.3.25,1
18.4.26,18.4.26,1
18.5.27,18.5.27,1
18.6.28,18.6.28,1
18.7.29,18.7.29,1
18.8.30,18.8.30,1
18.9.31,18.9.31,1
