1.1.1,1.1.1,1
2.1.2,2.1.2,1
2.2.3,2.2.3,1
2.3.4,2.3.4,1
3.1.5,3.1.5,1
4.1.6,4.1.6,1
4.2.7,4.2.7,1
5.1.8,5.1.8,1
6.1.9,6.1.9,1
7.1.10,7.1.10,1
8.1.11,8.1.11,1
9.1.12,9.1.12,1
10.1.13,10.1.13,1
11.1.14,11.1.14,1
12.1.15,12.1.15,1
13.1.16,13.1.16,1
13.2.17,13.2.17,1
13.3.18,13.3.18,1
13.4.19,13.4.19,1
13.5.20,13.5.20,1
14.1.21,14.1.21,1
15.1.22,15.1.22,1
15.2.23,15.2.23,1
15.3.24,15.3.24,1
15.4.25,15.4.25,1
16.1.26,16.1.26,1
16.2.27,16.2.27,1
16.3.28,16.3.28,1
16.4.29,16.4.29,1
17.1.30,17.1.30,1
17.2.31,17.2.31,1
17.3.32,17.3.32,1
17.4.33,17.4.33,1
18.1.34,18.1.34,1
19.1.35,19.1.35,1
20.1.36,20.1.36,1
21.1.37,21.1.37,1
22.1.38,22.1.38,1
