1.1.1,1.1.1,1
2.1.2,2.1.2,1
2.2.3,2.2.3,1
2.3.4,2.3.4,1
3.1.5,3.1.5,1
3.2.6,3.2.6,1
3.3.7,3.3.7,1
3.4.8,3.4.8,1
3.5.9,3.5.9,1
3.6.10,3.6.10,1
3.7.11,3.7.11,1
3.8.12,3.8.12,1
3.9.13,3.9.13,1
3.10.14,3.10.14,1
3.11.15,3.11.15,1
3.12.16,3.12.16,1
3.13.17,3.13.17,1
3.14.18,3.14.18,1
3.15.19,3.15.19,1
4.1.20,4.1.20,1
5.1.21,5.1.21,1
6.1.22,6.1.22,1
7.1.23,7.1.23,1
7.2.24,7.2.24,1
7.3.25,7.3.25,1
8.1.26,8.1.26,1
9.1.27,9.1.27,1
10.1.28,10.1.28,1
11.1.29,11.1.29,1
11.2.30,11.2.30,1
11.3.31,11.3.31,1
12.1.32,12.1.32,1
12.2.33,12.2.33,1
12.3.34,12.3.34,1
12.4.35,12.4.35,1
12.5.36,12.5.36,1
12.6.37,12.6.37,1
13.1.38,13.1.38,1
14.1.39,14.1.39,1
15.1.40,15.1.40,1
16.1.41,16.1.41,1
16.2.42,16.2.42,1
17.1.43,17.1.43,1
18.1.44,18.1.44,1
19.1.45,19.1.45,1
19.2.46,19.2.46,1
19.3.47,19.3.47,1
19.4.48,19.4.48,1
19.5.49,19.5.49,1
19.6.50,19.6.50,1
19.7.51,19.7.51,1
19.8.52,19.8.52,1
19.9.53,19.9.53,1
19.10.54,19.10.54,1
20.1.55,20.1.55,1
21.1.56,21.1.56,1
22.1.57,22.1.57,1
22.2.58,22.2.58,1
22.3.59,22.3.59,1
23.1.60,23.1.60,1
24.1.61,24.1.61,1
25.1.62,25.1.62,1
26.1.63,26.1.63,1
27.1.64,27.1.64,1
28.1.65,28.1.65,1
28.2.66,28.2.66,1
28.3.67,28.3.67,1
28.4.68,28.4.68,1
28.5.69,28.5.69,1
29.1.70,29.1.70,1
30.1.71,30.1.71,1
31.1.72,31.1.72,1
31.2.73,31.2.73,1
31.3.74,31.3.74,1
31.4.75,31.4.75,1
32.1.76,32.1.76,1
33.1.77,33.1.77,1
33.2.78,33.2.78,1
33.3.79,33.3.79,1
33.4.80,33.4.80,1
33.5.81,33.5.81,1
33.6.82,33.6.82,1
33.7.83,33.7.83,1
33.8.84,33.8.84,1
33.9.85,33.9.85,1
33.10.86,33.10.86,1
34.1.87,34.1.87,1
35.1.88,35.1.88,1
36.1.89,36.1.89,1
37.1.90,37.1.90,1
38.1.91,38.1.91,1
38.2.92,38.2.92,1
38.3.93,38.3.93,1
38.4.94,38.4.94,1
38.5.95,38.5.95,1
38.6.96,38.6.96,1
38.7.97,38.7.97,1
39.1.98,39.1.98,1
40.1.99,40.1.99,1
41.1.100,41.1.100,1
41.2.101,41.2.101,1
41.3.102,41.3.102,1
41.4.103,41.4.103,1
42.1.104,42.1.104,1
43.1.105,43.1.105,1
44.1.106,44.1.106,1
45.1.107,45.1.107,1
45.2.108,45.2.108,1
45.3.109,45.3.109,1
45.4.110,45.4.110,1
45.5.111,45.5.111,1
45.6.112,45.6.112,1
46.1.113,46.1.113,1
46.2.114,46.2.114,1
46.3.115,46.3.115,1
46.4.116,46.4.116,1
47.1.117,47.1.117,1
48.1.118,48.1.118,1
49.1.119,49.1.119,1
50.1.120,50.1.120,1
51.1.121,51.1.121,1
52.1.122,52.1.122,1
52.2.123,52.2.123,1
52.3.124,52.3.124,1
52.4.125,52.4.125,1
52.5.126,52.5.126,1
52.6.127,52.6.127,1
52.7.128,52.7.128,1
52.8.129,52.8.129,1
52.9.130,52.9.130,1
52.10.131,52.10.131,1
52.11.132,52.11.132,1
52.12.133,52.12.133,1
52.13.134,52.13.134,0.9250001
52.14.135,52.14.135,1
52.15.136,52.15.136,1
53.1.137,53.1.137,1
54.1.138,54.1.138,1
55.1.139,55.1.139,1
56.1.140,56.1.140,1
57.1.141,57.1.141,1
58.1.142,58.1.142,1
59.1.143,59.1.143,1
60.1.144,60.1.144,1
61.1.145,61.1.145,1
62.1.146,62.1.146,1
63.1.147,63.1.147,1
64.1.148,64.1.148,1
65.1.149,65.1.149,1
65.2.150,65.2.150,1
65.3.151,65.3.151,1
65.4.152,65.4.152,1
65.5.153,65.5.153,1
65.6.154,65.6.154,1
65.7.155,65.7.155,1
66.1.156,66.1.156,1
67.1.157,67.1.157,1
68.1.158,68.1.158,1
69.1.159,69.1.159,1
70.1.160,70.1.160,1
71.1.161,71.1.161,1
72.1.162,72.1.162,1
73.1.163,73.1.163,1
74.1.164,74.1.164,1
75.1.165,75.1.165,1
76.1.166,76.1.166,1
77.1.167,77.1.167,1
78.1.168,78.1.168,1
79.1.169,79.1.169,1
80.1.170,80.1.170,1
81.1.171,81.1.171,1
82.1.172,82.1.172,1
83.1.173,83.1.173,1
84.1.174,84.1.174,1
85.1.175,85.1.175,1
86.1.176,86.1.176,1
87.1.177,87.1.177,1
88.1.178,88.1.178,1
89.1.179,89.1.179,1
89.2.180,89.2.180,1
90.1.181,90.1.181,1
90.2.182,90.2.182,1
90.3.183,90.3.183,1
90.4.184,90.4.184,1
90.5.185,90.5.185,1
90.6.186,90.6.186,1
90.7.187,90.7.187,1
91.1.188,91.1.188,1
92.1.189,92.1.189,1
93.1.190,93.1.190,1
94.1.191,94.1.191,1
95.1.192,95.1.192,1
96.1.193,96.1.193,1
97.1.194,97.1.194,1
98.1.195,98.1.195,1
99.1.196,99.1.196,1
100.1.197,100.1.197,1
101.1.198,101.1.198,1
102.1.199,102.1.199,1
103.1.200,103.1.200,1
104.1.201,104.1.201,1
104.2.202,104.2.202,1
104.3.203,104.3.203,1
105.1.204,105.1.204,1
106.1.205,106.1.205,1
107.1.206,107.1.206,1
108.1.207,108.1.207,1
108.2.208,108.2.208,1
108.3.209,108.3.209,1
108.4.210,108.4.210,1
108.5.211,108.5.211,1
108.6.212,108.6.212,1
108.7.213,108.7.213,1
109.1.214,109.1.214,1
110.1.215,110.1.215,1
111.1.216,111.1.216,1
112.1.217,112.1.217,1
113.1.218,113.1.218,1
114.1.219,114.1.219,1
115.1.220,115.1.220,1
116.1.221,116.1.221,1
117.1.222,117.1.222,1
118.1.223,118.1.223,1
119.1.224,119.1.224,1
120.1.225,120.1.225,1
121.1.226,121.1.226,1
122.1.227,122.1.227,1
122.2.228,122.2.228,1
122.3.229,122.3.229,1
123.1.230,123.1.230,1
124.1.231,124.1.231,1
125.1.232,125.1.232,1
126.1.233,126.1.233,1
127.1.234,127.1.234,1
128.1.235,128.1.235,1
128.2.236,128.2.236,1
128.3.237,128.3.237,1
128.4.238,128.4.238,1
128.5.239,128.5.239,1
128.6.240,128.6.240,1
128.7.241,128.7.241,1
128.8.242,128.8.242,1
128.9.243,128.9.243,1
128.10.244,128.10.244,1
128.11.245,128.11.245,1
128.12.246,128.12.246,1
128.13.247,128.13.247,1
128.14.248,128.14.248,1
128.15.249,128.15.249,1
128.16.250,128.16.250,1
128.17.251,128.17.251,1
128.18.252,128.18.252,1
128.19.253,128.19.253,1
128.20.254,128.20.254,1
128.21.255,128.21.255,1
128.22.256,128.22.256,1
128.23.257,128.23.257,1
128.24.258,128.24.258,1
128.25.259,128.25.259,1
128.26.260,128.26.260,1
128.27.261,128.27.261,1
128.28.262,128.28.262,1
128.29.263,128.29.263,1
128.30.264,128.30.264,1
128.31.265,128.31.265,1
128.32.266,128.32.266,1
128.33.267,128.33.267,1
128.34.268,128.34.268,1
128.35.269,128.35.269,1
128.36.270,128.36.270,1
128.37.271,128.37.271,1
128.38.272,128.38.272,1
128.39.273,128.39.273,1
128.40.274,128.40.274,1
128.41.275,128.41.275,1
129.1.276,129.1.276,1
130.1.277,130.1.277,1
131.1.278,131.1.278,1
132.1.279,132.1.279,1
133.1.280,133.1.280,1
134.1.281,134.1.281,1
135.1.282,135.1.282,1
136.1.283,136.1.283,1
137.1.284,137.1.284,1
138.1.285,138.1.285,1
139.1.286,139.1.286,1
140.1.287,140.1.287,1
141.1.288,141.1.288,1
142.1.289,142.1.289,1
143.1.290,143.1.290,1
144.1.291,144.1.291,1
145.1.292,145.1.292,1
146.1.293,146.1.293,1
147.1.294,147.1.294,1
148.1.295,148.1.295,1
149.1.296,149.1.296,1
150.1.297,150.1.297,1
151.1.298,151.1.298,1
152.1.299,152.1.299,1
153.1.300,153.1.300,1
154.1.301,154.1.301,1
155.1.302,155.1.302,1
156.1.303,156.1.303,1
157.1.304,157.1.304,1
158.1.305,158.1.305,1
159.1.306,159.1.306,1
160.1.307,160.1.307,1
161.1.308,161.1.308,1
162.1.309,162.1.309,1
163.1.310,163.1.310,1
164.1.311,164.1.311,1
165.1.312,165.1.312,1
166.1.313,166.1.313,1
167.1.314,167.1.314,1
168.1.315,168.1.315,1
169.1.316,169.1.316,1
170.1.317,170.1.317,1
171.1.318,171.1.318,1
172.1.319,172.1.319,1
173.1.320,173.1.320,1
174.1.321,174.1.321,1
175.1.322,175.1.322,1
176.1.323,176.1.323,1
177.1.324,177.1.324,1
178.1.325,178.1.325,1
179.1.326,179.1.326,1
180.1.327,180.1.327,1
