1.1.1,1.1.1,1
2.1.2,2.1.2,1
2.2.3,2.2.3,1
2.3.4,2.3.4,1
2.4.5,2.4.5,1
2.5.6,2.5.6,1
3.1.7,3.1.7,1
3.2.8,3.2.8,1
3.3.9,3.3.9,1
3.4.10,3.4.10,1
3.5.11,3.5.11,1
3.6.12,3.6.12,1
3.7.13,3.7.13,1
3.8.14,3.8.14,1
3.9.15,3.9.15,1
3.10.16,3.10.16,1
3.11.17,3.11.17,1
3.12.18,3.12.18,1
3.13.19,3.13.19,1
3.14.20,3.14.20,1
3.15.21,3.15.21,1
4.1.22,4.1.22,1
5.1.23,5.1.23,1
6.1.24,6.1.24,1
6.2.25,6.2.25,1
6.3.26,6.3.26,1
7.1.27,7.1.27,1
8.1.28,8.1.28,1
9.1.29,9.1.29,1
10.1.30,10.1.30,1
11.1.31,11.1.31,1
11.2.32,11.2.32,1
11.3.33,11.3.33,1
11.4.34,11.4.34,1
11.5.35,11.5.35,1
11.6.36,11.6.36,1
12.1.37,12.1.37,1
13.1.38,13.1.38,1
14.1.39,14.1.39,1
14.2.40,14.2.40,1
15.1.41,15.1.41,1
16.1.42,16.1.42,1
17.1.43,17.1.43,1
17.2.44,17.2.44,1
17.3.45,17.3.45,1
17.4.46,17.4.46,1
17.5.47,17.5.47,1
17.6.48,17.6.48,1
17.7.49,17.7.49,1
17.8.50,17.8.50,1
17.9.51,17.9.51,1
17.10.52,17.10.52,1
18.1.53,18.1.53,1
19.1.54,19.1.54,1
20.1.55,20.1.55,1
20.2.56,20.2.56,1
20.3.57,20.3.57,1
21.1.58,21.1.58,1
22.1.59,22.1.59,1
23.1.60,23.1.60,1
24.1.61,24.1.61,1
25.1.62,25.1.62,1
26.1.63,26.1.63,1
26.2.64,26.2.64,1
26.3.65,26.3.65,1
26.4.66,26.4.66,1
26.5.67,26.5.67,1
27.1.68,27.1.68,1
28.1.69,28.1.69,1
29.1.70,29.1.70,1
29.2.71,29.2.71,1
29.3.72,29.3.72,1
29.4.73,29.4.73,1
30.1.74,30.1.74,1
31.1.75,31.1.75,1
31.2.76,31.2.76,1
31.3.77,31.3.77,1
31.4.78,31.4.78,1
31.5.79,31.5.79,1
31.6.80,31.6.80,1
31.7.81,31.7.81,1
31.8.82,31.8.82,1
31.9.83,31.9.83,1
31.10.84,31.10.84,1
32.1.85,32.1.85,1
33.1.86,33.1.86,1
34.1.87,34.1.87,1
35.1.88,35.1.88,1
35.2.89,35.2.89,1
35.3.90,35.3.90,1
35.4.91,35.4.91,1
35.5.92,35.5.92,1
35.6.93,35.6.93,1
35.7.94,35.7.94,1
36.1.95,36.1.95,1
37.1.96,37.1.96,1
38.1.97,38.1.97,1
38.2.98,38.2.98,1
38.3.99,38.3.99,1
38.4.100,38.4.100,1
39.1.101,39.1.101,1
40.1.102,40.1.102,1
41.1.103,41.1.103,1
41.2.104,41.2.104,1
41.3.105,41.3.105,1
41.4.106,41.4.106,1
41.5.107,41.5.107,1
41.6.108,41.6.108,1
42.1.109,42.1.109,1
42.2.110,42.2.110,1
42.3.111,42.3.111,1
42.4.112,42.4.112,1
43.1.113,43.1.113,1
44.1.114,44.1.114,1
45.1.115,45.1.115,1
46.1.116,46.1.116,1
47.1.117,47.1.117,1
48.1.118,48.1.118,1
48.2.119,48.2.119,1
48.3.120,48.3.120,1
48.4.121,48.4.121,1
48.5.122,48.5.122,1
48.6.123,48.6.123,1
48.7.124,48.7.124,1
48.8.125,48.8.125,1
48.9.126,48.9.126,1
48.10.127,48.10.127,1
48.11.128,48.11.128,1
48.12.129,48.12.129,1
48.13.130,48.13.130,1
48.14.131,48.14.131,1
48.15.132,48.15.132,1
49.1.133,49.1.133,1
50.1.134,50.1.134,1
51.1.135,51.1.135,1
52.1.136,52.1.136,1
53.1.137,53.1.137,1
54.1.138,54.1.138,1
55.1.139,55.1.139,1
56.1.140,56.1.140,1
57.1.141,57.1.141,1
58.1.142,58.1.142,1
59.1.143,59.1.143,1
60.1.144,60.1.144,1
61.1.145,61.1.145,1
61.2.146,61.2.146,1
61.3.147,61.3.147,1
61.4.148,61.4.148,1
61.5.149,61.5.149,1
61.6.150,61.6.150,1
61.7.151,61.7.151,1
62.1.152,62.1.152,1
63.1.153,63.1.153,1
64.1.154,64.1.154,1
65.1.155,65.1.155,1
66.1.156,66.1.156,1
67.1.157,67.1.157,1
68.1.158,68.1.158,1
69.1.159,69.1.159,1
70.1.160,70.1.160,1
71.1.161,71.1.161,1
72.1.162,72.1.162,1
73.1.163,73.1.163,1
74.1.164,74.1.164,1
75.1.165,75.1.165,1
76.1.166,76.1.166,1
77.1.167,77.1.167,1
78.1.168,78.1.168,1
79.1.169,79.1.169,1
80.1.170,80.1.170,1
81.1.171,81.1.171,1
82.1.172,82.1.172,1
83.1.173,83.1.173,1
84.1.174,84.1.174,1
85.1.175,85.1.175,1
85.2.176,85.2.176,1
86.1.177,86.1.177,1
86.2.178,86.2.178,1
86.3.179,86.3.179,1
86.4.180,86.4.180,1
86.5.181,86.5.181,1
86.6.182,86.6.182,1
86.7.183,86.7.183,1
87.1.184,87.1.184,1
88.1.185,88.1.185,1
89.1.186,89.1.186,1
90.1.187,90.1.187,1
91.1.188,91.1.188,1
92.1.189,92.1.189,1
93.1.190,93.1.190,1
94.1.191,94.1.191,1
95.1.192,95.1.192,1
96.1.193,96.1.193,1
97.1.194,97.1.194,1
98.1.195,98.1.195,1
99.1.196,99.1.196,1
100.1.197,100.1.197,1
100.2.198,100.2.198,1
100.3.199,100.3.199,1
101.1.200,101.1.200,1
102.1.201,102.1.201,1
103.1.202,103.1.202,1
104.1.203,104.1.203,1
104.2.204,104.2.204,1
104.3.205,104.3.205,1
104.4.206,104.4.206,1
104.5.207,104.5.207,1
104.6.208,104.6.208,1
104.7.209,104.7.209,1
105.1.210,105.1.210,1
106.1.211,106.1.211,1
107.1.212,107.1.212,1
108.1.213,108.1.213,1
109.1.214,109.1.214,1
110.1.215,110.1.215,1
111.1.216,111.1.216,1
112.1.217,112.1.217,1
113.1.218,113.1.218,1
114.1.219,114.1.219,1
115.1.220,115.1.220,1
116.1.221,116.1.221,1
117.1.222,117.1.222,1
118.1.223,118.1.223,1
119.1.224,119.1.224,1
120.1.225,120.1.225,1
121.1.226,121.1.226,1
122.1.227,122.1.227,1
123.1.228,123.1.228,1
124.1.229,124.1.229,1
124.2.230,124.2.230,1
124.3.231,124.3.231,1
124.4.232,124.4.232,1
124.5.233,124.5.233,1
124.6.234,124.6.234,1
124.7.235,124.7.235,1
124.8.236,124.8.236,1
124.9.237,124.9.237,1
124.10.238,124.10.238,1
124.11.239,124.11.239,1
124.12.240,124.12.240,1
124.13.241,124.13.241,1
124.14.242,124.14.242,1
124.15.243,124.15.243,1
124.16.244,124.16.244,1
124.17.245,124.17.245,1
124.18.246,124.18.246,1
124.19.247,124.19.247,1
124.20.248,124.20.248,1
124.21.249,124.21.249,1
124.22.250,124.22.250,1
124.23.251,124.23.251,1
124.24.252,124.24.252,1
124.25.253,124.25.253,1
124.26.254,124.26.254,1
124.27.255,124.27.255,1
124.28.256,124.28.256,1
124.29.257,124.29.257,1
124.30.258,124.30.258,1
124.31.259,124.31.259,1
124.32.260,124.32.260,1
124.33.261,124.33.261,1
124.34.262,124.34.262,1
124.35.263,124.35.263,1
124.36.264,124.36.264,1
124.37.265,124.37.265,1
124.38.266,124.38.266,1
124.39.267,124.39.267,1
124.40.268,124.40.268,1
124.41.269,124.41.269,1
125.1.270,125.1.270,1
126.1.271,126.1.271,1
127.1.272,127.1.272,1
128.1.273,128.1.273,1
129.1.274,129.1.274,1
130.1.275,130.1.275,1
131.1.276,131.1.276,1
132.1.277,132.1.277,1
133.1.278,133.1.278,1
134.1.279,134.1.279,1
135.1.280,135.1.280,1
136.1.281,136.1.281,1
137.1.282,137.1.282,1
138.1.283,138.1.283,1
139.1.284,139.1.284,1
140.1.285,140.1.285,1
141.1.286,141.1.286,1
142.1.287,142.1.287,1
143.1.288,143.1.288,1
144.1.289,144.1.289,1
145.1.290,145.1.290,1
146.1.291,146.1.291,1
147.1.292,147.1.292,1
148.1.293,148.1.293,1
149.1.294,149.1.294,1
150.1.295,150.1.295,1
151.1.296,151.1.296,1
152.1.297,152.1.297,1
153.1.298,153.1.298,1
154.1.299,154.1.299,1
155.1.300,155.1.300,1
156.1.301,156.1.301,1
157.1.302,157.1.302,1
158.1.303,158.1.303,1
159.1.304,159.1.304,1
160.1.305,160.1.305,1
161.1.306,161.1.306,1
162.1.307,162.1.307,1
163.1.308,163.1.308,1
164.1.309,164.1.309,1
165.1.310,165.1.310,1
166.1.311,166.1.311,1
167.1.312,167.1.312,1
168.1.313,168.1.313,1
169.1.314,169.1.314,1
170.1.315,170.1.315,1
171.1.316,171.1.316,1
172.1.317,172.1.317,1
173.1.318,173.1.318,1
174.1.319,174.1.319,1
175.1.320,175.1.320,1
176.1.321,176.1.321,1
