_,3.3.30,0
_,3.4.31,0
_,3.5.32,0
_,3.6.33,0
_,3.8.35,0
_,3.9.36,0
_,3.14.41,0
_,3.15.42,0
_,3.16.43,0
_,3.17.44,0
_,3.18.45,0
_,3.19.46,0
_,3.20.47,0
_,3.21.48,0
_,3.22.49,0
_,4.14.63,0
_,4.15.64,0
_,4.16.65,0
_,4.17.66,0
_,4.18.67,0
_,4.19.68,0
_,5.1.76,0
_,6.1.77,0
_,6.2.78,0
_,6.3.79,0
_,6.4.80,0
_,6.5.81,0
_,6.6.82,0
_,6.7.83,0
_,6.8.84,0
_,6.9.85,0
_,6.10.86,0
_,6.11.87,0
_,6.12.88,0
_,6.13.89,0
_,6.14.90,0
_,6.15.91,0
_,6.16.92,0
_,6.17.93,0
_,6.18.94,0
_,6.19.95,0
_,6.20.96,0
_,6.21.97,0
_,7.4.101,0
_,11.3.132,0
_,11.6.135,0
_,15.95.251,0
_,21.2.289,0
_,21.3.290,0
_,21.4.291,0
1.1.1,1.1.1,1
1.2.2,1.2.2,1
1.3.3,1.3.3,1
2.1.4,2.1.4,1
2.2.5,2.2.5,1
2.3.6,2.3.6,1
2.4.7,2.4.7,1
2.5.8,2.5.8,1
2.6.9,2.6.9,1
2.7.10,2.7.10,1
2.8.11,2.8.11,1
2.9.12,2.9.12,1
2.10.13,2.10.13,1
2.11.14,2.11.14,1
2.12.15,2.12.15,1
2.13.16,2.13.16,1
2.14.17,2.14.17,1
2.15.18,2.15.18,1
2.16.19,2.16.19,1
2.17.20,2.17.20,1
2.18.21,2.18.21,1
2.19.22,2.19.22,0.65395576
2.20.23,_,0
2.21.24,_,0
2.22.25,2.20.23,1
2.23.26,2.21.24,1
2.24.27,2.22.25,1
2.25.28,2.23.26,1
2.26.29,2.24.27,1
3.1.30,3.1.28,1
3.2.31,3.2.29,0.63925993
3.3.32,_,0
3.4.33,_,0
3.5.34,_,0
3.6.35,_,0
3.7.36,_,0
3.8.37,3.7.34,0.5739114
3.9.38,3.10.37,1
3.10.39,3.11.38,0.9129255
3.11.40,3.12.39,1
3.12.41,3.13.40,1
3.13.42,3.7.34,0.6203902
4.1.43,4.1.50,1
4.2.44,4.2.51,1
4.3.45,4.3.52,1
4.4.46,4.4.53,1
4.5.47,4.5.54,1
4.6.48,4.6.55,1
4.7.49,4.7.56,1
4.8.50,4.8.57,1
4.9.51,4.9.58,1
4.10.52,4.10.59,1
4.11.53,4.11.60,1
4.12.54,4.12.61,1
4.13.55,4.13.62,1
5.1.56,_,0
5.2.57,_,0
6.1.58,_,0
7.1.59,_,0
8.1.60,7.1.98,0.8309605
8.2.61,7.2.99,0.68027496
8.3.62,4.20.69,1
8.4.63,_,0
9.1.64,4.21.70,1
9.2.65,4.22.71,1
9.3.66,4.23.72,1
9.4.67,4.24.73,1
9.5.68,4.25.74,0.8909944
9.6.69,4.26.75,0.8442278
9.7.70,7.3.100,1
9.8.71,8.1.102,1
9.9.72,8.2.103,1
9.10.73,8.3.104,1
9.11.74,8.4.105,1
9.12.75,8.5.106,1
9.13.76,8.6.107,1
9.14.77,8.7.108,1
9.15.78,8.8.109,1
9.16.79,8.9.110,1
9.17.80,8.10.111,1
9.18.81,8.11.112,1
9.19.82,8.12.113,1
9.20.83,8.13.114,1
9.21.84,8.14.115,1
9.22.85,8.15.116,1
9.23.86,8.16.117,1
9.24.87,8.17.118,1
9.25.88,8.18.119,1
9.26.89,8.19.120,1
10.1.90,9.1.121,1
10.2.91,9.2.122,1
10.3.92,9.3.123,1
10.4.93,9.4.124,1
10.5.94,9.5.125,1
11.1.95,10.1.126,1
11.2.96,10.2.127,1
11.3.97,10.3.128,1
11.4.98,10.4.129,1
12.1.99,11.1.130,1
12.2.100,11.2.131,1
12.3.101,11.4.133,1
12.4.102,11.5.134,1
12.5.103,11.7.136,1
12.6.104,11.8.137,1
12.7.105,11.9.138,1
12.8.106,11.10.139,1
12.9.107,11.11.140,1
12.10.108,11.12.141,1
12.11.109,11.13.142,1
12.12.110,11.14.143,1
12.13.111,11.15.144,1
12.14.112,11.16.145,1
12.15.113,11.17.146,1
12.16.114,11.18.147,1
12.17.115,11.19.148,1
12.18.116,11.20.149,1
13.1.117,12.1.150,1
13.2.118,12.2.151,1
13.3.119,12.3.152,1
14.1.120,13.1.153,0.77852607
14.2.121,13.2.154,0.82101476
15.1.122,14.1.155,1
15.2.123,14.2.156,1
16.1.124,15.1.157,0.78869134
16.2.125,15.2.158,1
16.3.126,15.3.159,1
16.4.127,15.4.160,1
16.5.128,15.5.161,1
16.6.129,15.6.162,1
16.7.130,15.7.163,1
16.8.131,15.8.164,1
16.9.132,15.9.165,1
16.10.133,15.10.166,1
16.11.134,15.11.167,1
16.12.135,15.12.168,1
16.13.136,15.13.169,1
16.14.137,15.14.170,1
16.15.138,15.15.171,1
16.16.139,15.16.172,1
16.17.140,15.17.173,1
16.18.141,15.18.174,1
16.19.142,15.19.175,1
16.20.143,15.20.176,1
16.21.144,_,0
16.22.145,15.21.177,1
16.23.146,15.22.178,1
16.24.147,15.23.179,1
16.25.148,15.24.180,1
16.26.149,15.25.181,1
16.27.150,15.26.182,1
16.28.151,15.27.183,1
16.29.152,15.28.184,1
16.30.153,15.29.185,1
16.31.154,15.30.186,1
16.32.155,15.31.187,1
16.33.156,15.32.188,1
16.34.157,15.33.189,1
16.35.158,15.34.190,1
16.36.159,15.35.191,1
16.37.160,15.36.192,1
16.38.161,15.37.193,1
16.39.162,15.38.194,1
16.40.163,15.39.195,1
16.41.164,15.40.196,1
16.42.165,15.41.197,1
16.43.166,15.42.198,1
16.44.167,15.43.199,1
16.45.168,15.44.200,1
16.46.169,15.45.201,1
16.47.170,15.46.202,1
16.48.171,15.47.203,1
16.49.172,15.48.204,1
16.50.173,15.49.205,1
16.51.174,15.50.206,1
16.52.175,15.51.207,1
16.53.176,15.52.208,1
16.54.177,15.53.209,1
16.55.178,15.54.210,1
16.56.179,15.55.211,1
16.57.180,15.56.212,1
16.58.181,15.57.213,1
16.59.182,15.58.214,1
16.60.183,15.59.215,1
16.61.184,15.60.216,1
16.62.185,15.61.217,1
16.63.186,15.62.218,1
16.64.187,15.63.219,1
16.65.188,15.64.220,1
16.66.189,15.65.221,1
16.67.190,15.66.222,1
16.68.191,15.67.223,1
16.69.192,15.68.224,1
16.70.193,15.69.225,1
16.71.194,15.70.226,1
16.72.195,15.71.227,1
16.73.196,15.72.228,1
16.74.197,15.73.229,1
16.75.198,15.74.230,1
16.76.199,15.75.231,1
16.77.200,15.76.232,1
16.78.201,15.77.233,1
16.79.202,15.78.234,1
16.80.203,15.79.235,1
16.81.204,15.80.236,1
16.82.205,15.81.237,1
16.83.206,15.82.238,1
16.84.207,15.83.239,1
16.85.208,15.84.240,1
16.86.209,15.85.241,1
16.87.210,15.86.242,1
16.88.211,15.87.243,1
16.89.212,15.88.244,1
16.90.213,15.89.245,1
16.91.214,15.90.246,1
16.92.215,15.91.247,1
16.93.216,15.92.248,1
16.94.217,15.93.249,1
16.95.218,15.94.250,1
16.96.219,_,0
16.97.220,_,0
16.98.221,_,0
16.99.222,15.96.252,0.6062733
16.100.223,_,0
16.101.224,_,0
17.1.225,_,0
17.2.226,_,0
17.3.227,16.1.253,0.634423
17.4.228,16.2.254,0.64617676
18.1.229,17.1.255,1
18.2.230,17.2.256,1
18.3.231,17.3.257,1
18.4.232,17.4.258,1
18.5.233,17.5.259,1
18.6.234,17.6.260,1
18.7.235,17.7.261,1
18.8.236,17.8.262,1
18.9.237,17.9.263,1
18.10.238,17.10.264,1
18.11.239,17.11.265,1
18.12.240,17.12.266,1
19.1.241,18.1.267,1
19.2.242,18.2.268,1
19.3.243,18.3.269,1
19.4.244,18.4.270,1
19.5.245,18.5.271,1
19.6.246,18.6.272,1
19.7.247,18.7.273,1
19.8.248,18.8.274,0.84680855
19.9.249,18.9.275,1
19.10.250,18.10.276,1
19.11.251,18.11.277,1
19.12.252,18.12.278,1
19.13.253,18.13.279,1
20.1.254,19.1.280,1
20.2.255,19.2.281,1
21.1.256,20.1.282,1
21.2.257,20.2.283,1
21.3.258,20.3.284,1
21.4.259,20.4.285,1
21.5.260,20.5.286,1
21.6.261,20.6.287,1
22.1.262,21.1.288,0.58857906
22.2.263,_,0
22.3.264,_,0
22.4.265,_,0
23.1.266,22.1.292,1
23.2.267,22.2.293,1
23.3.268,22.3.294,1
23.4.269,22.4.295,1
23.5.270,22.5.296,1
23.6.271,22.6.297,1
24.1.272,23.1.298,1
