1.1.1,1.1.1,1
1.2.2,1.2.2,1
1.3.3,1.3.3,1
1.4.4,1.4.4,1
1.5.5,1.5.5,1
2.1.6,2.1.6,1
3.1.7,3.1.7,1
4.1.8,4.1.8,0.9806452
5.1.9,5.1.9,1
6.1.10,6.1.10,1
6.2.11,6.2.11,1
6.3.12,6.3.12,1
6.4.13,6.4.13,1
6.5.14,6.5.14,1
7.1.15,7.1.15,1
7.2.16,7.2.16,1
7.3.17,7.3.17,1
7.4.18,7.4.18,1
7.5.19,7.5.19,1
8.1.20,8.1.20,1
8.2.21,8.2.21,1
8.3.22,8.3.22,1
8.4.23,8.4.23,1
8.5.24,8.5.24,1
8.6.25,8.6.25,1
8.7.26,8.7.26,1
8.8.27,8.8.27,1
8.9.28,8.9.28,1
9.1.29,9.1.29,1
9.2.30,9.2.30,1
9.3.31,9.3.31,1
9.4.32,9.4.32,1
9.5.33,9.5.33,1
10.1.34,10.1.34,1
10.2.35,10.2.35,1
10.3.36,10.3.36,1
10.4.37,10.4.37,1
10.5.38,10.5.38,1
10.6.39,10.6.39,1
10.7.40,10.7.40,1
10.8.41,10.8.41,1
11.1.42,11.1.42,1
12.1.43,12.1.43,1
13.1.44,13.1.44,1
14.1.45,14.1.45,1
14.2.46,14.2.46,1
14.3.47,14.3.47,1
14.4.48,14.4.48,1
14.5.49,14.5.49,1
14.6.50,14.6.50,1
14.7.51,14.7.51,1
14.8.52,14.8.52,1
14.9.53,14.9.53,1
14.10.54,14.10.54,1
14.11.55,14.11.55,1
15.1.56,15.1.56,1
16.1.57,16.1.57,1
16.2.58,16.2.58,1
16.3.59,16.3.59,1
16.4.60,16.4.60,1
16.5.61,16.5.61,1
16.6.62,16.6.62,1
16.7.63,16.7.63,1
16.8.64,16.8.64,1
17.1.65,17.1.65,1
17.2.66,17.2.66,1
17.3.67,17.3.67,1
17.4.68,17.4.68,1
17.5.69,17.5.69,1
17.6.70,17.6.70,1
17.7.71,17.7.71,1
18.1.72,18.1.72,1
