_,4.1.8,0
_,4.2.9,0
_,4.3.10,0
_,12.1.24,0
1.1.1,1.1.1,1
1.2.2,1.2.2,1
1.3.3,1.3.3,1
1.4.4,1.4.4,1
1.5.5,1.5.5,1
2.1.6,2.1.6,1
3.1.7,3.1.7,1
4.1.8,_,0
5.1.9,5.1.11,1
6.1.10,6.1.12,1
7.1.11,7.1.13,1
8.1.12,8.1.14,1
8.2.13,8.2.15,1
8.3.14,8.3.16,1
8.4.15,8.4.17,1
8.5.16,8.5.18,1
8.6.17,8.6.19,1
9.1.18,9.1.20,1
10.1.19,10.1.21,1
11.1.20,11.1.22,1
11.2.21,11.2.23,1
12.1.22,_,0
13.1.23,13.1.25,1
13.2.24,13.2.26,1
13.3.25,13.3.27,1
14.1.26,14.1.28,1
14.2.27,14.2.29,1
14.3.28,14.3.30,1
15.1.29,15.1.31,1
15.2.30,15.2.32,1
15.3.31,15.3.33,1
