1.1.1,1.1.1,1
1.2.2,1.2.2,1
1.3.3,1.3.3,1
1.4.4,1.4.4,1
1.5.5,1.5.5,1
2.1.6,2.1.6,1
3.1.7,3.1.7,1
4.1.8,4.1.8,1
5.1.9,5.1.9,1
6.1.10,6.1.10,1
7.1.11,7.1.11,1
8.1.12,8.1.12,1
8.2.13,_,0
8.3.14,8.2.13,1
8.4.15,8.3.14,1
8.5.16,8.4.15,1
8.6.17,8.5.16,1
8.7.18,8.6.17,1
9.1.19,9.1.18,1
10.1.20,10.1.19,1
11.1.21,11.1.20,1
11.2.22,11.2.21,1
12.1.23,12.1.22,1
13.1.24,13.1.23,1
13.2.25,13.2.24,1
13.3.26,13.3.25,1
14.1.27,14.1.26,1
14.2.28,14.2.27,1
14.3.29,14.3.28,1
15.1.30,15.1.29,1
15.2.31,15.2.30,1
15.3.32,15.3.31,1
