1.1.1,_,0
2.1.2,1.1.1,1
3.1.3,2.1.2,1
4.1.4,3.1.3,1
5.1.5,4.1.4,1
6.1.6,5.1.5,1
7.1.7,6.1.6,1
7.2.8,6.2.7,1
7.3.9,6.3.8,1
7.4.10,6.4.9,1
7.5.11,6.5.10,1
8.1.12,7.1.11,1
8.2.13,7.2.12,1
8.3.14,7.3.13,1
9.1.15,8.1.14,1
10.1.16,9.1.15,1
10.2.17,9.2.16,1
10.3.18,9.3.17,1
10.4.19,9.4.18,1
10.5.20,9.5.19,1
10.6.21,9.6.20,1
10.7.22,9.7.21,1
10.8.23,9.8.22,1
10.9.24,9.9.23,1
10.10.25,9.10.24,1
10.11.26,9.11.25,1
10.12.27,9.12.26,1
10.13.28,9.13.27,1
