1.1.1,_,0
2.1.2,1.1.1,1
3.1.3,2.1.2,1
4.1.4,3.1.3,1
5.1.5,4.1.4,1
6.1.6,5.1.5,1
7.1.7,6.1.6,1
8.1.8,7.1.7,1
8.2.9,7.2.8,1
9.1.10,8.1.9,1
10.1.11,9.1.10,1
11.1.12,10.1.11,1
11.2.13,10.2.12,1
11.3.14,10.3.13,1
11.4.15,10.4.14,1
11.5.16,10.5.15,1
11.6.17,10.6.16,1
11.7.18,10.7.17,1
11.8.19,10.8.18,1
11.9.20,10.9.19,1
12.1.21,11.1.20,1
13.1.22,12.1.21,1
14.1.23,13.1.22,1
14.2.24,13.2.23,1
14.3.25,13.3.24,1
