1.1.1,1.1.1,1
2.1.2,2.1.2,1
3.1.3,3.1.3,1
3.2.4,3.2.4,1
4.1.5,4.1.5,1
4.2.6,4.2.6,1
4.3.7,4.3.7,1
4.4.8,4.4.8,1
4.5.9,4.5.9,1
4.6.10,4.6.10,1
4.7.11,4.7.11,1
5.1.12,5.1.12,1
5.2.13,5.2.13,1
6.1.14,6.1.14,1
6.2.15,6.2.15,1
7.1.16,7.1.16,1
7.2.17,7.2.17,1
8.1.18,8.1.18,1
9.1.19,9.1.19,1
9.2.20,9.2.20,1
10.1.21,10.1.21,1
10.2.22,10.2.22,1
10.3.23,10.3.23,1
10.4.24,10.4.24,1
10.5.25,10.5.25,1
10.6.26,10.6.26,1
10.7.27,10.7.27,1
10.8.28,10.8.28,1
10.9.29,10.9.29,1
11.1.30,11.1.30,1
11.2.31,11.2.31,1
11.3.32,11.3.32,1
12.1.33,12.1.33,1
12.2.34,12.2.34,1
13.1.35,13.1.35,1
14.1.36,14.1.36,1
14.2.37,14.2.37,1
15.1.38,15.1.38,1
15.2.39,15.2.39,1
