1.1.1,1.1.1,1
2.1.2,2.1.2,1
3.1.3,3.1.3,1
4.1.4,4.1.4,1
5.1.5,5.1.5,1
6.1.6,6.1.6,1
7.1.7,7.1.7,1
8.1.8,8.1.8,1
9.1.9,9.1.9,1
9.2.10,9.2.10,1
9.3.11,9.3.11,1
9.4.12,9.4.12,1
9.5.13,9.5.13,1
10.1.14,10.1.14,1
11.1.15,11.1.15,1
11.2.16,11.2.16,1
12.1.17,12.1.17,1
13.1.18,13.1.18,1
13.2.19,13.2.19,1
13.3.20,13.3.20,1
13.4.21,13.4.21,1
14.1.22,14.1.22,1
15.1.23,15.1.23,1
16.1.24,16.1.24,0.98831177
16.2.25,16.2.25,1
17.1.26,17.1.26,1
18.1.27,18.1.27,1
18.2.28,18.2.28,1
18.3.29,18.3.29,1
18.4.30,18.4.30,1
18.5.31,18.5.31,1
18.6.32,18.6.32,1
18.7.33,18.7.33,1
18.8.34,18.8.34,1
