_,16.3.34,0
_,16.5.36,0
_,17.9.45,0
_,17.29.65,0
1.1.1,1.1.1,1
1.2.2,1.2.2,1
1.3.3,1.3.3,1
1.4.4,1.4.4,1
1.5.5,1.5.5,1
2.1.6,2.1.6,1
3.1.7,3.1.7,1
4.1.8,4.1.8,0.82555556
5.1.9,5.1.9,1
6.1.10,6.1.10,1
6.2.11,6.2.11,1
6.3.12,6.3.12,0.97279
6.4.13,6.4.13,1
6.5.14,6.5.14,1
6.6.15,6.6.15,1
6.7.16,6.7.16,1
7.1.17,7.1.17,0.9970443
8.1.18,8.1.18,1
9.1.19,9.1.19,1
10.1.20,10.1.20,1
11.1.21,11.1.21,1
11.2.22,11.2.22,1
11.3.23,11.3.23,0.9308586
12.1.24,_,0
13.1.25,_,0
14.1.26,12.1.24,1
15.1.27,13.1.25,1
16.1.28,14.1.26,1
16.2.29,14.2.27,1
17.1.30,15.1.28,1
17.2.31,15.2.29,1
17.3.32,15.3.30,1
17.4.33,15.4.31,1
18.1.34,16.1.32,1
18.2.35,16.2.33,1
18.3.36,_,0
18.4.37,16.4.35,1
18.5.38,_,0
19.1.39,17.1.37,1
19.2.40,17.2.38,1
19.3.41,17.3.39,1
19.4.42,17.4.40,1
19.5.43,17.5.41,1
19.6.44,17.6.42,1
19.7.45,17.7.43,1
19.8.46,17.8.44,1
19.9.47,_,0
19.10.48,17.10.46,1
19.11.49,17.11.47,1
19.12.50,17.12.48,1
19.13.51,17.13.49,1
19.14.52,17.14.50,1
19.15.53,17.15.51,1
19.16.54,_,0
19.17.55,17.16.52,0.8371324
19.18.56,_,0
19.19.57,_,0
19.20.58,17.17.53,1
19.21.59,17.18.54,1
19.22.60,17.19.55,1
19.23.61,17.20.56,1
19.24.62,17.21.57,1
19.25.63,17.22.58,1
19.26.64,17.23.59,1
19.27.65,17.24.60,1
19.28.66,17.25.61,1
19.29.67,17.26.62,1
19.30.68,17.27.63,1
19.31.69,17.28.64,1
19.32.70,_,0
19.33.71,17.30.66,1
19.34.72,17.31.67,1
19.35.73,17.32.68,1
19.36.74,17.33.69,1
19.37.75,17.34.70,1
19.38.76,17.35.71,1
19.39.77,17.36.72,1
19.40.78,17.37.73,1
19.41.79,17.38.74,1
19.42.80,17.39.75,1
19.43.81,17.40.76,1
19.44.82,17.41.77,1
19.45.83,17.42.78,1
19.46.84,17.43.79,1
19.47.85,17.44.80,1
19.48.86,17.45.81,1
19.49.87,17.46.82,1
19.50.88,17.47.83,1
19.51.89,17.48.84,1
19.52.90,17.49.85,1
19.53.91,17.50.86,1
19.54.92,17.51.87,1
19.55.93,17.52.88,1
19.56.94,17.53.89,1
19.57.95,17.54.90,1
19.58.96,17.55.91,1
19.59.97,17.56.92,1
19.60.98,17.57.93,1
19.61.99,17.58.94,1
19.62.100,17.59.95,1
19.63.101,17.60.96,1
19.64.102,17.61.97,1
19.65.103,17.62.98,1
19.66.104,17.63.99,1
19.67.105,17.64.100,1
19.68.106,17.65.101,1
19.69.107,17.66.102,1
19.70.108,17.67.103,1
19.71.109,17.68.104,1
19.72.110,17.69.105,1
19.73.111,17.70.106,1
19.74.112,17.71.107,1
19.75.113,17.72.108,1
19.76.114,17.73.109,1
19.77.115,17.74.110,1
19.78.116,17.75.111,1
19.79.117,17.76.112,1
19.80.118,17.77.113,1
19.81.119,17.78.114,1
19.82.120,17.79.115,1
19.83.121,17.80.116,1
19.84.122,17.81.117,1
19.85.123,17.82.118,1
19.86.124,17.83.119,1
19.87.125,17.84.120,1
19.88.126,17.85.121,1
19.89.127,17.86.122,1
19.90.128,17.87.123,1
19.91.129,17.88.124,1
19.92.130,17.89.125,1
19.93.131,17.90.126,1
19.94.132,17.91.127,1
19.95.133,17.92.128,1
19.96.134,17.93.129,1
19.97.135,17.94.130,1
19.98.136,17.95.131,1
19.99.137,17.96.132,1
19.100.138,17.97.133,1
19.101.139,17.98.134,1
19.102.140,17.99.135,1
19.103.141,17.100.136,1
19.104.142,17.101.137,1
19.105.143,17.102.138,1
19.106.144,17.103.139,1
19.107.145,17.104.140,1
19.108.146,17.105.141,1
19.109.147,17.106.142,1
19.110.148,17.107.143,1
19.111.149,17.108.144,1
19.112.150,17.109.145,1
19.113.151,17.110.146,1
19.114.152,17.111.147,1
19.115.153,17.112.148,1
19.116.154,17.113.149,1
19.117.155,17.114.150,1
19.118.156,17.115.151,1
19.119.157,17.116.152,1
19.120.158,17.117.153,1
19.121.159,17.118.154,1
19.122.160,17.119.155,1
19.123.161,17.120.156,1
19.124.162,17.121.157,1
19.125.163,17.122.158,1
19.126.164,17.123.159,1
19.127.165,17.124.160,1
19.128.166,17.125.161,1
19.129.167,17.126.162,1
19.130.168,17.127.163,1
19.131.169,17.128.164,1
19.132.170,17.129.165,1
19.133.171,17.130.166,1
20.1.172,18.1.167,1
20.2.173,18.2.168,1
21.1.174,19.1.169,1
21.2.175,19.2.170,1
21.3.176,19.3.171,1
21.4.177,19.4.172,1
21.5.178,19.5.173,1
21.6.179,19.6.174,1
21.7.180,19.7.175,1
21.8.181,19.8.176,1
21.9.182,19.9.177,1
21.10.183,19.10.178,1
22.1.184,20.1.179,1
23.1.185,21.1.180,1
23.2.186,21.2.181,1
23.3.187,21.3.182,1
23.4.188,21.4.183,1
23.5.189,21.5.184,1
23.6.190,21.6.185,1
23.7.191,21.7.186,1
23.8.192,21.8.187,1
23.9.193,21.9.188,1
23.10.194,21.10.189,1
23.11.195,21.11.190,1
23.12.196,21.12.191,1
23.13.197,21.13.192,1
23.14.198,21.14.193,1
24.1.199,22.1.194,1
24.2.200,22.2.195,1
24.3.201,22.3.196,1
24.4.202,22.4.197,1
25.1.203,23.1.198,1
25.2.204,23.2.199,1
26.1.205,24.1.200,1
27.1.206,25.1.201,0.8023343
27.2.207,25.2.202,1
27.3.208,25.3.203,1
28.1.209,26.1.204,1
29.1.210,_,0
29.2.211,_,0
29.3.212,27.1.205,0.72030824
29.4.213,27.2.206,1
29.5.214,27.3.207,0.90706646
29.6.215,27.4.208,1
29.7.216,27.5.209,0.77885276
29.8.217,27.6.210,0.970284
29.9.218,27.7.211,1
29.10.219,27.8.212,0.91610897
30.1.220,28.1.213,1
30.2.221,28.2.214,1
30.3.222,28.3.215,0.92879534
30.4.223,28.4.216,1
30.5.224,28.5.217,0.89787227
