1.1.1,1.1.1,1
2.1.2,2.1.2,1
3.1.3,3.1.3,1
4.1.4,4.1.4,1
5.1.5,5.1.5,1
6.1.6,6.1.6,1
7.1.7,7.1.7,1
7.2.8,7.2.8,1
7.3.9,7.3.9,1
7.4.10,7.4.10,1
7.5.11,7.5.11,1
8.1.12,8.1.12,1
8.2.13,8.2.13,1
8.3.14,8.3.14,1
9.1.15,9.1.15,1
10.1.16,10.1.16,1
10.2.17,10.2.17,1
10.3.18,10.3.18,1
10.4.19,10.4.19,1
10.5.20,10.5.20,1
10.6.21,10.6.21,1
10.7.22,10.7.22,1
10.8.23,10.8.23,1
10.9.24,10.9.24,1
10.10.25,10.10.25,1
10.11.26,10.11.26,1
10.12.27,10.12.27,1
10.13.28,10.13.28,1
