1.1.1,1.1.1,1
2.1.2,2.1.2,0.9074471
3.1.3,3.1.3,0.93047535
4.1.4,4.1.4,1
4.2.5,4.2.5,1
5.1.6,5.1.6,0.8027246
6.1.7,6.1.7,1
7.1.8,7.1.8,1
8.1.9,8.1.9,0.8990097
9.1.10,9.1.10,1
9.2.11,9.2.11,1
9.3.12,9.3.12,1
10.1.13,10.1.13,1
11.1.14,11.1.14,1
12.1.15,12.1.15,0.8857143
13.1.16,13.1.16,1
13.2.17,13.2.17,1
14.1.18,14.1.18,1
14.2.19,14.2.19,1
14.3.20,14.3.20,1
14.4.21,14.4.21,1
14.5.22,14.5.22,1
14.6.23,14.6.23,1
14.7.24,14.7.24,1
14.8.25,14.8.25,1
14.9.26,14.9.26,1
14.10.27,14.10.27,1
14.11.28,14.11.28,1
15.1.29,15.1.29,1
15.2.30,15.2.30,1
15.3.31,15.3.31,1
15.4.32,15.4.32,1
15.5.33,15.5.33,1
15.6.34,15.6.34,1
15.7.35,15.7.35,1
15.8.36,15.8.36,1
15.9.37,15.9.37,1
15.10.38,15.10.38,1
15.11.39,15.11.39,1
15.12.40,15.12.40,1
15.13.41,15.13.41,1
15.14.42,15.14.42,1
15.15.43,15.15.43,1
15.16.44,15.16.44,1
15.17.45,15.17.45,1
15.18.46,15.18.46,1
15.19.47,15.19.47,1
16.1.48,16.1.48,0.7994135
17.1.49,17.1.49,1
17.2.50,17.2.50,1
18.1.51,18.1.51,0.8123903
19.1.52,19.1.52,1
20.1.53,20.1.53,0.9316592
21.1.54,21.1.54,1
21.2.55,21.2.55,1
21.3.56,21.3.56,1
21.4.57,21.4.57,1
21.5.58,21.5.58,1
21.6.59,21.6.59,1
22.1.60,22.1.60,1
22.2.61,22.2.61,1
22.3.62,22.3.62,1
22.4.63,22.4.63,1
22.5.64,22.5.64,1
22.6.65,22.6.65,1
22.7.66,22.7.66,1
22.8.67,22.8.67,1
23.1.68,23.1.68,1
23.2.69,23.2.69,1
23.3.70,23.3.70,1
24.1.71,24.1.71,1
24.2.72,24.2.72,1
24.3.73,24.3.73,1
