1.1.1,_,0
2.1.2,1.1.1,1
3.1.3,2.1.2,1
4.1.4,3.1.3,1
5.1.5,4.1.4,1
6.1.6,5.1.5,1
7.1.7,6.1.6,1
8.1.8,7.1.7,1
9.1.9,8.1.8,1
10.1.10,9.1.9,1
11.1.11,10.1.10,1
12.1.12,11.1.11,1
13.1.13,12.1.12,1
14.1.14,13.1.13,1
14.2.15,13.2.14,1
14.3.16,13.3.15,1
14.4.17,13.4.16,1
14.5.18,13.5.17,1
15.1.19,14.1.18,1
16.1.20,15.1.19,1
17.1.21,16.1.20,1
17.2.22,16.2.21,1
18.1.23,17.1.22,1
19.1.24,18.1.23,1
20.1.25,19.1.24,1
20.2.26,19.2.25,1
21.1.27,20.1.26,1
22.1.28,21.1.27,1
23.1.29,22.1.28,1
23.2.30,22.2.29,1
24.1.31,23.1.30,1
