1.1.1,1.1.1,1
2.1.2,2.1.2,1
3.1.3,3.1.3,1
4.1.4,4.1.4,1
5.1.5,5.1.5,1
6.1.6,6.1.6,1
7.1.7,7.1.7,1
8.1.8,8.1.8,1
9.1.9,9.1.9,1
10.1.10,10.1.10,1
11.1.11,11.1.11,1
12.1.12,12.1.12,1
13.1.13,13.1.13,1
14.1.14,14.1.14,1
14.2.15,14.2.15,1
14.3.16,14.3.16,1
14.4.17,14.4.17,1
14.5.18,14.5.18,1
15.1.19,15.1.19,1
16.1.20,16.1.20,1
17.1.21,17.1.21,1
17.2.22,17.2.22,1
18.1.23,18.1.23,1
19.1.24,19.1.24,1
20.1.25,20.1.25,1
20.2.26,20.2.26,1
21.1.27,21.1.27,1
22.1.28,22.1.28,1
23.1.29,23.1.29,1
23.2.30,23.2.30,1
24.1.31,24.1.31,1
