1.1.1,1.1.1,1
2.1.2,2.1.2,1
3.1.3,3.1.3,1
4.1.4,4.1.4,1
5.1.5,5.1.5,1
6.1.6,6.1.6,1
7.1.7,7.1.7,0.9869566
8.1.8,8.1.8,1
9.1.9,9.1.9,1
10.1.10,10.1.10,1
11.1.11,11.1.11,1
12.1.12,12.1.12,1
13.1.13,13.1.13,1
13.2.14,13.2.14,1
13.3.15,13.3.15,1
13.4.16,13.4.16,1
13.5.17,13.5.17,1
14.1.18,14.1.18,1
15.1.19,15.1.19,1
16.1.20,16.1.20,1
16.2.21,16.2.21,1
16.3.22,16.3.22,1
17.1.23,17.1.23,1
18.1.24,18.1.24,1
18.2.25,18.2.25,1
19.1.26,19.1.26,0.99661016
20.1.27,20.1.27,1
20.2.28,20.2.28,1
20.3.29,20.3.29,1
21.1.30,21.1.30,1
