1.1.1,1.1.1,1
2.1.2,2.1.2,1
3.1.3,3.1.3,1
4.1.4,4.1.4,1
5.1.5,5.1.5,1
6.1.6,6.1.6,1
6.2.7,6.2.7,1
7.1.8,7.1.8,1
8.1.9,8.1.9,1
8.2.10,8.2.10,1
9.1.11,9.1.11,1
10.1.12,10.1.12,1
10.2.13,10.2.13,1
11.1.14,11.1.14,1
12.1.15,12.1.15,1
12.2.16,12.2.16,1
12.3.17,12.3.17,1
12.4.18,12.4.18,1
12.5.19,12.5.19,1
12.6.20,12.6.20,1
12.7.21,12.7.21,1
13.1.22,13.1.22,1
