1.1.1,1.1.1,1
1.2.2,1.2.2,1
1.3.3,1.3.3,1
1.4.4,1.4.4,1
1.5.5,1.5.5,1
2.1.6,2.1.6,1
3.1.7,3.1.7,1
4.1.8,4.1.8,1
5.1.9,5.1.9,1
6.1.10,6.1.10,1
6.2.11,6.2.11,1
6.3.12,6.3.12,1
6.4.13,6.4.13,1
6.5.14,6.5.14,1
6.6.15,6.6.15,1
6.7.16,6.7.16,1
7.1.17,7.1.17,1
8.1.18,8.1.18,1
8.2.19,8.2.19,1
8.3.20,8.3.20,1
8.4.21,8.4.21,1
8.5.22,8.5.22,1
8.6.23,8.6.23,1
8.7.24,8.7.24,1
8.8.25,8.8.25,1
8.9.26,8.9.26,1
8.10.27,8.10.27,1
8.11.28,8.11.28,1
8.12.29,8.12.29,1
9.1.30,9.1.30,0.82000005
10.1.31,10.1.31,1
10.2.32,10.2.32,1
10.3.33,10.3.33,1
10.4.34,10.4.34,1
10.5.35,10.5.35,1
10.6.36,10.6.36,1
10.7.37,10.7.37,1
10.8.38,10.8.38,1
10.9.39,10.9.39,1
11.1.40,11.1.40,1
11.2.41,11.2.41,1
11.3.42,11.3.42,1
11.4.43,11.4.43,1
11.5.44,11.5.44,1
11.6.45,11.6.45,1
11.7.46,11.7.46,1
11.8.47,11.8.47,1
11.9.48,11.9.48,1
11.10.49,11.10.49,1
11.11.50,11.11.50,1
11.12.51,11.12.51,1
11.13.52,11.13.52,1
11.14.53,11.14.53,1
11.15.54,11.15.54,1
11.16.55,11.16.55,1
11.17.56,11.17.56,1
12.1.57,12.1.57,1
12.2.58,12.2.58,1
12.3.59,12.3.59,1
