1.1.1,1.1.1,1
2.1.2,2.1.2,1
3.1.3,3.1.3,1
4.1.4,4.1.4,0.97746366
5.1.5,5.1.5,1
6.1.6,6.1.6,0.9722307
7.1.7,7.1.7,1
7.2.8,7.2.8,1
8.1.9,8.1.9,0.97704375
9.1.10,9.1.10,1
9.2.11,9.2.11,1
10.1.12,10.1.12,0.9716611
11.1.13,11.1.13,1
11.2.14,11.2.14,1
12.1.15,12.1.15,0.94457173
13.1.16,13.1.16,1
13.2.17,13.2.17,1
13.3.18,13.3.18,1
13.4.19,13.4.19,1
13.5.20,13.5.20,1
13.6.21,13.6.21,1
13.7.22,13.7.22,1
14.1.23,14.1.23,1
15.1.24,15.1.24,1
