1.1.1,1.1.1,1
1.2.2,1.2.2,1
1.3.3,1.3.3,1
1.4.4,1.4.4,1
1.5.5,1.5.5,1
2.1.6,2.1.6,1
3.1.7,3.1.7,1
4.1.8,4.1.8,1
5.1.9,5.1.9,1
5.2.10,5.2.10,1
6.1.11,6.1.11,1
6.2.12,6.2.12,1
6.3.13,6.3.13,1
7.1.14,7.1.14,1
8.1.15,8.1.15,1
8.2.16,8.2.16,1
9.1.17,9.1.17,1
10.1.18,10.1.18,1
10.2.19,10.2.19,1
10.3.20,10.3.20,1
10.4.21,10.4.21,1
10.5.22,10.5.22,1
11.1.23,11.1.23,1
12.1.24,12.1.24,1
12.2.25,12.2.25,1
13.1.26,13.1.26,1
14.1.27,14.1.27,1
15.1.28,15.1.28,1
16.1.29,16.1.29,0.98
16.2.30,16.2.30,1
16.3.31,16.3.31,1
17.1.32,17.1.32,1
17.2.33,17.2.33,1
17.3.34,17.3.34,1
17.4.35,17.4.35,1
17.5.36,17.5.36,1
18.1.37,18.1.37,1
18.2.38,18.2.38,1
18.3.39,18.3.39,1
