_,8.1.16,0
_,8.3.18,0
_,10.1.20,0
_,10.15.34,0
_,14.1.40,0
_,14.8.47,0
_,16.1.49,0
_,16.3.51,0
_,17.5.56,0
_,17.6.57,0
1.1.1,1.1.1,1
1.2.2,1.2.2,1
1.3.3,1.3.3,1
1.4.4,1.4.4,1
1.5.5,1.5.5,1
2.1.6,2.1.6,1
3.1.7,3.1.7,1
4.1.8,4.1.8,0.9774437
4.2.9,4.2.9,1
4.3.10,4.3.10,1
5.1.11,5.1.11,1
5.2.12,5.2.12,1
5.3.13,5.3.13,0.9473729
6.1.14,6.1.14,1
7.1.15,7.1.15,0.9641499
8.1.16,8.2.17,1
9.1.17,9.1.19,0.8567474
10.1.18,10.2.21,1
10.2.19,10.3.22,1
10.3.20,10.4.23,1
10.4.21,10.5.24,1
10.5.22,10.6.25,1
10.6.23,10.7.26,1
10.7.24,10.8.27,1
10.8.25,10.9.28,1
10.9.26,10.10.29,1
10.10.27,10.11.30,1
10.11.28,10.12.31,1
10.12.29,10.13.32,1
10.13.30,10.14.33,1
11.1.31,11.1.35,1
11.2.32,11.2.36,1
11.3.33,11.3.37,0.96925044
12.1.34,12.1.38,1
13.1.35,13.1.39,0.9662247
14.1.36,14.2.41,1
14.2.37,14.3.42,1
14.3.38,14.4.43,1
14.4.39,14.5.44,1
14.5.40,14.6.45,1
14.6.41,14.7.46,1
15.1.42,15.1.48,0.7618952
16.1.43,16.2.50,1
17.1.44,17.1.52,0.8244041
17.2.45,17.3.54,0.78854764
17.3.46,17.4.55,0.70973647
17.4.47,17.2.53,1
17.5.48,17.7.58,0.8092265
