1.1.1,1.1.1,1
1.2.2,1.2.2,1
1.3.3,1.3.3,1
1.4.4,1.4.4,1
1.5.5,1.5.5,1
2.1.6,2.1.6,1
3.1.7,3.1.7,1
4.1.8,4.1.8,1
4.2.9,4.2.9,1
4.3.10,4.3.10,1
5.1.11,5.1.11,1
6.1.12,6.1.12,1
6.2.13,6.2.13,1
6.3.14,6.3.14,1
6.4.15,6.4.15,1
6.5.16,6.5.16,1
6.6.17,6.6.17,1
6.7.18,6.7.18,1
7.1.19,7.1.19,1
7.2.20,7.2.20,1
7.3.21,7.3.21,1
8.1.22,8.1.22,1
8.2.23,8.2.23,1
8.3.24,8.3.24,1
8.4.25,8.4.25,1
9.1.26,9.1.26,1
10.1.27,10.1.27,1
10.2.28,10.2.28,1
10.3.29,10.3.29,1
10.4.30,10.4.30,1
10.5.31,10.5.31,1
10.6.32,10.6.32,1
10.7.33,10.7.33,1
10.8.34,10.8.34,1
10.9.35,10.9.35,1
10.10.36,10.10.36,1
10.11.37,10.11.37,1
10.12.38,_,0
11.1.39,11.1.38,1
12.1.40,12.1.39,1
13.1.41,13.1.40,1
13.2.42,13.2.41,1
13.3.43,13.3.42,1
14.1.44,14.1.43,1
15.1.45,15.1.44,1
15.2.46,15.2.45,1
15.3.47,15.3.46,1
15.4.48,15.4.47,1
15.5.49,15.5.48,1
15.6.50,15.6.49,1
15.7.51,15.7.50,1
15.8.52,15.8.51,1
15.9.53,15.9.52,1
15.10.54,15.10.53,1
15.11.55,15.11.54,1
15.12.56,15.12.55,1
16.1.57,16.1.56,1
17.1.58,17.1.57,1
17.2.59,17.2.58,1
17.3.60,17.3.59,1
17.4.61,17.4.60,1
17.5.62,17.5.61,1
17.6.63,17.6.62,1
17.7.64,17.7.63,1
18.1.65,18.1.64,1
19.1.66,19.1.65,1
20.1.67,20.1.66,1
20.2.68,20.2.67,1
20.3.69,20.3.68,1
20.4.70,20.4.69,1
20.5.71,20.5.70,1
21.1.72,21.1.71,1
22.1.73,22.1.72,1
22.2.74,22.2.73,1
22.3.75,22.3.74,1
