_,12.1.15,0
_,12.2.16,0
1.1.1,1.1.1,1
2.1.2,2.1.2,1
3.1.3,3.1.3,1
3.2.4,3.2.4,1
4.1.5,4.1.5,1
5.1.6,5.1.6,1
6.1.7,6.1.7,1
7.1.8,7.1.8,1
8.1.9,8.1.9,1
8.2.10,8.2.10,1
8.3.11,8.3.11,1
9.1.12,9.1.12,1
10.1.13,10.1.13,1
11.1.14,11.1.14,1
12.1.15,13.1.17,1
12.2.16,13.2.18,1
12.3.17,13.3.19,1
12.4.18,13.4.20,1
12.5.19,13.5.21,1
12.6.20,13.6.22,1
12.7.21,13.7.23,1
12.8.22,13.8.24,1
12.9.23,13.9.25,1
12.10.24,13.10.26,1
12.11.25,13.11.27,1
13.1.26,14.1.28,1
13.2.27,_,0
13.3.28,14.2.29,1
13.4.29,14.3.30,1
13.5.30,14.4.31,1
13.6.31,14.5.32,1
13.7.32,14.6.33,1
13.8.33,14.7.34,1
13.9.34,14.8.35,1
13.10.35,14.9.36,1
13.11.36,14.10.37,1
13.12.37,14.11.38,1
13.13.38,14.12.39,1
13.14.39,14.13.40,1
13.15.40,14.14.41,1
13.16.41,14.15.42,1
13.17.42,14.16.43,1
13.18.43,14.17.44,1
13.19.44,14.18.45,1
13.20.45,14.19.46,1
14.1.46,15.1.47,1
15.1.47,16.1.48,1
15.2.48,16.2.49,1
16.1.49,17.1.50,1
17.1.50,18.1.51,1
18.1.51,19.1.52,1
19.1.52,20.1.53,1
19.2.53,20.2.54,1
19.3.54,20.3.55,1
19.4.55,20.4.56,1
19.5.56,20.5.57,1
19.6.57,20.6.58,1
20.1.58,21.1.59,1
20.2.59,21.2.60,1
20.3.60,21.3.61,1
20.4.61,21.4.62,1
20.5.62,21.5.63,1
20.6.63,21.6.64,1
20.7.64,21.7.65,1
20.8.65,21.8.66,1
21.1.66,22.1.67,1
21.2.67,22.2.68,1
21.3.68,22.3.69,1
22.1.69,23.1.70,1
22.2.70,23.2.71,1
22.3.71,23.3.72,1
