_,13.1.18,0
_,13.54.71,0
1.1.1,1.1.1,1
2.1.2,2.1.2,1
3.1.3,3.1.3,1
3.2.4,3.2.4,1
3.3.5,3.3.5,1
4.1.6,4.1.6,1
5.1.7,5.1.7,1
6.1.8,6.1.8,1
7.1.9,7.1.9,1
8.1.10,8.1.10,1
9.1.11,9.1.11,1
10.1.12,10.1.12,1
10.2.13,10.2.13,1
10.3.14,10.3.14,1
10.4.15,10.4.15,1
11.1.16,11.1.16,1
12.1.17,12.1.17,1
13.1.18,13.2.19,1
13.2.19,13.3.20,1
13.3.20,13.4.21,1
13.4.21,13.5.22,1
13.5.22,13.6.23,1
13.6.23,13.7.24,1
13.7.24,13.8.25,1
13.8.25,13.9.26,1
13.9.26,13.10.27,1
13.10.27,13.11.28,1
13.11.28,13.12.29,1
13.12.29,13.13.30,1
13.13.30,13.14.31,1
13.14.31,13.15.32,1
13.15.32,13.16.33,1
13.16.33,13.17.34,1
13.17.34,13.18.35,1
13.18.35,13.19.36,1
13.19.36,13.20.37,1
13.20.37,13.21.38,1
13.21.38,13.22.39,1
13.22.39,13.23.40,1
13.23.40,13.24.41,1
13.24.41,13.25.42,1
13.25.42,13.26.43,1
13.26.43,13.27.44,1
13.27.44,13.28.45,1
13.28.45,13.29.46,1
13.29.46,13.30.47,1
13.30.47,13.31.48,1
13.31.48,13.32.49,1
13.32.49,13.33.50,1
13.33.50,13.34.51,1
13.34.51,13.35.52,1
13.35.52,13.36.53,1
13.36.53,13.37.54,1
13.37.54,13.38.55,1
13.38.55,13.39.56,1
13.39.56,13.40.57,1
13.40.57,13.41.58,1
13.41.58,13.42.59,1
13.42.59,13.43.60,1
13.43.60,13.44.61,1
13.44.61,13.45.62,1
13.45.62,13.46.63,1
13.46.63,13.47.64,1
13.47.64,13.48.65,1
13.48.65,13.49.66,1
13.49.66,13.50.67,1
13.50.67,13.51.68,1
13.51.68,13.52.69,1
13.52.69,13.53.70,0.7879856
13.53.70,13.55.72,1
13.54.71,13.56.73,0.88866293
13.55.72,13.57.74,1
13.56.73,13.58.75,1
13.57.74,13.59.76,1
13.58.75,13.60.77,1
13.59.76,13.61.78,1
13.60.77,13.62.79,1
13.61.78,13.63.80,1
13.62.79,13.64.81,1
13.63.80,13.65.82,1
13.64.81,13.66.83,1
13.65.82,13.67.84,1
13.66.83,13.68.85,1
13.67.84,13.69.86,1
13.68.85,13.70.87,1
13.69.86,13.71.88,1
13.70.87,13.72.89,1
13.71.88,13.73.90,1
