1.1.1,1.1.1,1
2.1.2,2.1.2,0.9386922
3.1.3,3.1.3,0.94390464
4.1.4,4.1.4,0.94890416
5.1.5,5.1.5,1
5.2.6,5.2.6,1
5.3.7,5.3.7,1
5.4.8,5.4.8,1
5.5.9,5.5.9,1
6.1.10,6.1.10,1
6.2.11,6.2.11,1
6.3.12,6.3.12,1
6.4.13,6.4.13,1
6.5.14,6.5.14,1
7.1.15,7.1.15,1
7.2.16,7.2.16,1
7.3.17,7.3.17,1
8.1.18,8.1.18,1
9.1.19,9.1.19,1
10.1.20,10.1.20,1
10.2.21,10.2.21,1
10.3.22,10.3.22,1
10.4.23,10.4.23,1
11.1.24,11.1.24,0.9538462
12.1.25,12.1.25,1
12.2.26,12.2.26,1
12.3.27,12.3.27,1
12.4.28,12.4.28,1
12.5.29,12.5.29,1
13.1.30,13.1.30,1
13.2.31,13.2.31,1
13.3.32,13.3.32,1
14.1.33,14.1.33,1
14.2.34,14.2.34,1
14.3.35,14.3.35,1
15.1.36,15.1.36,1
15.2.37,15.2.37,1
16.1.38,16.1.38,1
17.1.39,17.1.39,0.90400004
18.1.40,18.1.40,1
