1.1.1,1.1.1,1
2.1.2,2.1.2,0.91940016
3.1.3,3.1.3,0.9343877
4.1.4,4.1.4,0.87588334
5.1.5,5.1.5,1
6.1.6,6.1.6,1
6.2.7,6.2.7,1
6.3.8,6.3.8,1
7.1.9,7.1.9,1
8.1.10,8.1.10,0.9111111
9.1.11,9.1.11,1
9.2.12,9.2.12,1
9.3.13,9.3.13,1
9.4.14,9.4.14,1
9.5.15,9.5.15,1
9.6.16,9.6.16,1
9.7.17,9.7.17,1
10.1.18,10.1.18,1
10.2.19,10.2.19,1
10.3.20,10.3.20,1
10.4.21,10.4.21,1
10.5.22,10.5.22,1
10.6.23,10.6.23,1
11.1.24,11.1.24,1
12.1.25,12.1.25,0.85
13.1.26,13.1.26,1
14.1.27,14.1.27,1
14.2.28,14.2.28,1
14.3.29,14.3.29,1
14.4.30,14.4.30,1
14.5.31,14.5.31,1
14.6.32,14.6.32,1
14.7.33,14.7.33,1
15.1.34,15.1.34,1
16.1.35,16.1.35,1
16.2.36,16.2.36,1
16.3.37,16.3.37,1
16.4.38,16.4.38,1
16.5.39,16.5.39,1
16.6.40,16.6.40,1
16.7.41,16.7.41,1
17.1.42,17.1.42,0.9286405
18.1.43,18.1.43,0.8924649
19.1.44,19.1.44,1
19.2.45,19.2.45,1
19.3.46,19.3.46,1
