1.1.1,1.1.1,1
1.2.2,1.2.2,1
1.3.3,1.3.3,1
1.4.4,1.4.4,1
1.5.5,1.5.5,1
2.1.6,2.1.6,1
3.1.7,3.1.7,1
4.1.8,4.1.8,1
5.1.9,5.1.9,1
5.2.10,5.2.10,1
6.1.11,6.1.11,1
6.2.12,6.2.12,1
6.3.13,6.3.13,1
6.4.14,6.4.14,1
6.5.15,6.5.15,0.91724145
6.6.16,6.6.16,1
6.7.17,6.7.17,1
7.1.18,7.1.18,1
7.2.19,7.2.19,1
8.1.20,8.1.20,1
8.2.21,8.2.21,1
8.3.22,8.3.22,1
9.1.23,9.1.23,1
10.1.24,10.1.24,1
10.2.25,10.2.25,1
10.3.26,10.3.26,1
10.4.27,10.4.27,1
11.1.28,11.1.28,1
12.1.29,12.1.29,1
12.2.30,12.2.30,1
13.1.31,13.1.31,1
14.1.32,14.1.32,1
14.2.33,14.2.33,1
14.3.34,14.3.34,1
14.4.35,14.4.35,1
14.5.36,14.5.36,1
14.6.37,14.6.37,1
14.7.38,14.7.38,1
14.8.39,14.8.39,1
14.9.40,14.9.40,1
14.10.41,14.10.41,1
