_,3.1.3,0
1.1.1,1.1.1,1
2.1.2,2.1.2,1
3.1.3,4.1.4,1
4.1.4,5.1.5,1
5.1.5,6.1.6,1
6.1.6,7.1.7,1
7.1.7,8.1.8,1
8.1.8,9.1.9,1
9.1.9,10.1.10,1
10.1.10,11.1.11,1
10.2.11,11.2.12,1
10.3.12,11.3.13,1
10.4.13,11.4.14,1
10.5.14,11.5.15,1
10.6.15,11.6.16,1
10.7.16,11.7.17,1
10.8.17,11.8.18,1
10.9.18,11.9.19,1
11.1.19,12.1.20,1
12.1.20,13.1.21,1
13.1.21,14.1.22,1
14.1.22,15.1.23,1
15.1.23,16.1.24,1
16.1.24,17.1.25,1
17.1.25,18.1.26,1
18.1.26,19.1.27,1
19.1.27,20.1.28,1
19.2.28,20.2.29,1
19.3.29,20.3.30,1
20.1.30,21.1.31,1
21.1.31,22.1.32,1
22.1.32,23.1.33,1
22.2.33,23.2.34,1
22.3.34,23.3.35,1
23.1.35,24.1.36,1
24.1.36,25.1.37,1
25.1.37,26.1.38,1
