1.1.1,1.1.1,0.9809524
2.1.2,2.1.2,1
3.1.3,3.1.3,1
4.1.4,4.1.4,1
4.2.5,4.2.5,1
5.1.6,5.1.6,1
6.1.7,6.1.7,1
6.2.8,6.2.8,1
7.1.9,7.1.9,1
7.2.10,7.2.10,1
8.1.11,8.1.11,1
8.2.12,8.2.12,1
9.1.13,9.1.13,1
10.1.14,10.1.14,1
10.2.15,10.2.15,1
11.1.16,11.1.16,1
12.1.17,12.1.17,1
12.2.18,12.2.18,1
13.1.19,13.1.19,1
13.2.20,13.2.20,1
14.1.21,14.1.21,1
14.2.22,14.2.22,1
15.1.23,15.1.23,1
16.1.24,16.1.24,1
16.2.25,16.2.25,1
16.3.26,16.3.26,1
16.4.27,16.4.27,1
16.5.28,16.5.28,1
17.1.29,17.1.29,1
17.2.30,17.2.30,1
17.3.31,17.3.31,1
18.1.32,18.1.32,1
18.2.33,18.2.33,1
19.1.34,19.1.34,1
19.2.35,19.2.35,1
