_,3.1.3,0
_,5.1.5,0
_,6.1.6,0
_,6.2.7,0
_,6.3.8,0
1.1.1,1.1.1,1
2.1.2,2.1.2,1
3.1.3,4.1.4,1
4.1.4,7.1.9,1
5.1.5,8.1.10,1
6.1.6,9.1.11,1
7.1.7,10.1.12,1
7.2.8,10.2.13,1
7.3.9,10.3.14,1
8.1.10,11.1.15,1
9.1.11,12.1.16,1
9.2.12,12.2.17,1
10.1.13,13.1.18,1
11.1.14,14.1.19,1
12.1.15,15.1.20,1
12.2.16,15.2.21,1
12.3.17,15.3.22,1
13.1.18,16.1.23,1
14.1.19,17.1.24,1
14.2.20,17.2.25,1
14.3.21,17.3.26,1
14.4.22,17.4.27,1
15.1.23,18.1.28,1
15.2.24,18.2.29,1
16.1.25,19.1.30,1
17.1.26,20.1.31,1
18.1.27,21.1.32,1
