_,12.1.24,0
_,13.1.25,0
_,18.3.36,0
_,18.5.38,0
_,19.9.47,0
_,19.16.54,0
_,19.18.56,0
_,19.19.57,0
_,19.32.70,0
_,29.1.210,0
_,29.2.211,0
1.1.1,1.1.1,1
1.2.2,1.2.2,1
1.3.3,1.3.3,1
1.4.4,1.4.4,1
1.5.5,1.5.5,1
2.1.6,2.1.6,1
3.1.7,3.1.7,1
4.1.8,4.1.8,0.82555556
5.1.9,5.1.9,1
6.1.10,6.1.10,1
6.2.11,6.2.11,1
6.3.12,6.3.12,0.97279
6.4.13,6.4.13,1
6.5.14,6.5.14,1
6.6.15,6.6.15,1
6.7.16,6.7.16,1
7.1.17,7.1.17,0.9970443
8.1.18,8.1.18,1
9.1.19,9.1.19,1
10.1.20,10.1.20,1
11.1.21,11.1.21,1
11.2.22,11.2.22,1
11.3.23,11.3.23,0.9308586
12.1.24,14.1.26,1
13.1.25,15.1.27,1
14.1.26,16.1.28,1
14.2.27,16.2.29,1
15.1.28,17.1.30,1
15.2.29,17.2.31,1
15.3.30,17.3.32,1
15.4.31,17.4.33,1
16.1.32,18.1.34,1
16.2.33,18.2.35,1
16.3.34,_,0
16.4.35,18.4.37,1
16.5.36,_,0
17.1.37,19.1.39,1
17.2.38,19.2.40,1
17.3.39,19.3.41,1
17.4.40,19.4.42,1
17.5.41,19.5.43,1
17.6.42,19.6.44,1
17.7.43,19.7.45,1
17.8.44,19.8.46,1
17.9.45,_,0
17.10.46,19.10.48,1
17.11.47,19.11.49,1
17.12.48,19.12.50,1
17.13.49,19.13.51,1
17.14.50,19.14.52,1
17.15.51,19.15.53,1
17.16.52,19.17.55,0.8371324
17.17.53,19.20.58,1
17.18.54,19.21.59,1
17.19.55,19.22.60,1
17.20.56,19.23.61,1
17.21.57,19.24.62,1
17.22.58,19.25.63,1
17.23.59,19.26.64,1
17.24.60,19.27.65,1
17.25.61,19.28.66,1
17.26.62,19.29.67,1
17.27.63,19.30.68,1
17.28.64,19.31.69,1
17.29.65,_,0
17.30.66,19.33.71,1
17.31.67,19.34.72,1
17.32.68,19.35.73,1
17.33.69,19.36.74,1
17.34.70,19.37.75,1
17.35.71,19.38.76,1
17.36.72,19.39.77,1
17.37.73,19.40.78,1
17.38.74,19.41.79,1
17.39.75,19.42.80,1
17.40.76,19.43.81,1
17.41.77,19.44.82,1
17.42.78,19.45.83,1
17.43.79,19.46.84,1
17.44.80,19.47.85,1
17.45.81,19.48.86,1
17.46.82,19.49.87,1
17.47.83,19.50.88,1
17.48.84,19.51.89,1
17.49.85,19.52.90,1
17.50.86,19.53.91,1
17.51.87,19.54.92,1
17.52.88,19.55.93,1
17.53.89,19.56.94,1
17.54.90,19.57.95,1
17.55.91,19.58.96,1
17.56.92,19.59.97,1
17.57.93,19.60.98,1
17.58.94,19.61.99,1
17.59.95,19.62.100,1
17.60.96,19.63.101,1
17.61.97,19.64.102,1
17.62.98,19.65.103,1
17.63.99,19.66.104,1
17.64.100,19.67.105,1
17.65.101,19.68.106,1
17.66.102,19.69.107,1
17.67.103,19.70.108,1
17.68.104,19.71.109,1
17.69.105,19.72.110,1
17.70.106,19.73.111,1
17.71.107,19.74.112,1
17.72.108,19.75.113,1
17.73.109,19.76.114,1
17.74.110,19.77.115,1
17.75.111,19.78.116,1
17.76.112,19.79.117,1
17.77.113,19.80.118,1
17.78.114,19.81.119,1
17.79.115,19.82.120,1
17.80.116,19.83.121,1
17.81.117,19.84.122,1
17.82.118,19.85.123,1
17.83.119,19.86.124,1
17.84.120,19.87.125,1
17.85.121,19.88.126,1
17.86.122,19.89.127,1
17.87.123,19.90.128,1
17.88.124,19.91.129,1
17.89.125,19.92.130,1
17.90.126,19.93.131,1
17.91.127,19.94.132,1
17.92.128,19.95.133,1
17.93.129,19.96.134,1
17.94.130,19.97.135,1
17.95.131,19.98.136,1
17.96.132,19.99.137,1
17.97.133,19.100.138,1
17.98.134,19.101.139,1
17.99.135,19.102.140,1
17.100.136,19.103.141,1
17.101.137,19.104.142,1
17.102.138,19.105.143,1
17.103.139,19.106.144,1
17.104.140,19.107.145,1
17.105.141,19.108.146,1
17.106.142,19.109.147,1
17.107.143,19.110.148,1
17.108.144,19.111.149,1
17.109.145,19.112.150,1
17.110.146,19.113.151,1
17.111.147,19.114.152,1
17.112.148,19.115.153,1
17.113.149,19.116.154,1
17.114.150,19.117.155,1
17.115.151,19.118.156,1
17.116.152,19.119.157,1
17.117.153,19.120.158,1
17.118.154,19.121.159,1
17.119.155,19.122.160,1
17.120.156,19.123.161,1
17.121.157,19.124.162,1
17.122.158,19.125.163,1
17.123.159,19.126.164,1
17.124.160,19.127.165,1
17.125.161,19.128.166,1
17.126.162,19.129.167,1
17.127.163,19.130.168,1
17.128.164,19.131.169,1
17.129.165,19.132.170,1
17.130.166,19.133.171,1
18.1.167,20.1.172,1
18.2.168,20.2.173,1
19.1.169,21.1.174,1
19.2.170,21.2.175,1
19.3.171,21.3.176,1
19.4.172,21.4.177,1
19.5.173,21.5.178,1
19.6.174,21.6.179,1
19.7.175,21.7.180,1
19.8.176,21.8.181,1
19.9.177,21.9.182,1
19.10.178,21.10.183,1
20.1.179,22.1.184,1
21.1.180,23.1.185,1
21.2.181,23.2.186,1
21.3.182,23.3.187,1
21.4.183,23.4.188,1
21.5.184,23.5.189,1
21.6.185,23.6.190,1
21.7.186,23.7.191,1
21.8.187,23.8.192,1
21.9.188,23.9.193,1
21.10.189,23.10.194,1
21.11.190,23.11.195,1
21.12.191,23.12.196,1
21.13.192,23.13.197,1
21.14.193,23.14.198,1
22.1.194,24.1.199,1
22.2.195,24.2.200,1
22.3.196,24.3.201,1
22.4.197,24.4.202,1
23.1.198,25.1.203,1
23.2.199,25.2.204,1
24.1.200,26.1.205,1
25.1.201,27.1.206,0.8023343
25.2.202,27.2.207,1
25.3.203,27.3.208,1
26.1.204,28.1.209,1
27.1.205,29.3.212,0.72030824
27.2.206,29.4.213,1
27.3.207,29.5.214,0.90706646
27.4.208,29.6.215,1
27.5.209,29.7.216,0.77885276
27.6.210,29.8.217,0.970284
27.7.211,29.9.218,1
27.8.212,29.10.219,0.91610897
28.1.213,30.1.220,1
28.2.214,30.2.221,1
28.3.215,30.3.222,0.92879534
28.4.216,30.4.223,1
28.5.217,30.5.224,0.89787227
