1.1.1,1.1.1,1
1.2.2,1.2.2,1
1.3.3,1.3.3,1
1.4.4,1.4.4,1
1.5.5,1.5.5,1
2.1.6,2.1.6,1
2.2.7,2.2.7,1
2.3.8,2.3.8,1
2.4.9,2.4.9,1
2.5.10,2.5.10,1
2.6.11,2.6.11,0.99321127
3.1.12,3.1.12,1
4.1.13,4.1.13,1
5.1.14,5.1.14,0.9921973
5.2.15,5.2.15,1
5.3.16,5.3.16,1
6.1.17,6.1.17,1
6.2.18,6.2.18,1
6.3.19,6.3.19,1
6.4.20,6.4.20,1
6.5.21,6.5.21,1
6.6.22,6.6.22,1
6.7.23,6.7.23,1
6.8.24,6.8.24,1
6.9.25,6.9.25,1
6.10.26,6.10.26,1
6.11.27,6.11.27,1
6.12.28,6.12.28,1
6.13.29,6.13.29,1
6.14.30,6.14.30,1
6.15.31,6.15.31,1
7.1.32,7.1.32,1
8.1.33,8.1.33,0.9984733
9.1.34,9.1.34,1
9.2.35,9.2.35,1
9.3.36,9.3.36,1
9.4.37,9.4.37,1
9.5.38,9.5.38,1
10.1.39,10.1.39,1
10.2.40,10.2.40,1
10.3.41,10.3.41,1
10.4.42,10.4.42,1
10.5.43,10.5.43,1
10.6.44,10.6.44,1
10.7.45,10.7.45,1
10.8.46,10.8.46,1
10.9.47,10.9.47,1
10.10.48,10.10.48,1
10.11.49,10.11.49,1
10.12.50,10.12.50,1
10.13.51,10.13.51,1
10.14.52,10.14.52,1
10.15.53,10.15.53,1
10.16.54,10.16.54,1
10.17.55,10.17.55,1
10.18.56,10.18.56,1
10.19.57,10.19.57,1
10.20.58,10.20.58,1
10.21.59,10.21.59,1
10.22.60,10.22.60,1
10.23.61,10.23.61,1
10.24.62,10.24.62,1
10.25.63,10.25.63,1
10.26.64,10.26.64,1
10.27.65,10.27.65,1
10.28.66,10.28.66,1
10.29.67,10.29.67,1
10.30.68,10.30.68,1
11.1.69,11.1.69,1
12.1.70,12.1.70,1
12.2.71,12.2.71,1
12.3.72,12.3.72,1
12.4.73,12.4.73,1
