_,1.1.1,0
_,1.2.2,0
_,1.3.3,0
_,1.4.4,0
_,1.5.5,0
1.1.1,_,0
2.1.2,2.1.6,1
3.1.3,3.1.7,1
4.1.4,4.1.8,1
5.1.5,5.1.9,1
6.1.6,6.1.10,0.9904915
7.1.7,7.1.11,0.9767399
8.1.8,8.1.12,1
8.2.9,8.2.13,1
9.1.10,9.1.14,0.98383677
10.1.11,10.1.15,1
10.2.12,10.2.16,1
10.3.13,10.3.17,1
10.4.14,10.4.18,1
10.5.15,10.5.19,1
11.1.16,11.1.20,1
12.1.17,12.1.21,1
13.1.18,13.1.22,1
14.1.19,14.1.23,1
15.1.20,15.1.24,1
16.1.21,16.1.25,1
17.1.22,17.1.26,1
18.1.23,18.1.27,1
18.2.24,18.2.28,1
18.3.25,18.3.29,1
18.4.26,18.4.30,1
18.5.27,18.5.31,0.9302388
18.6.28,18.6.32,0.9606154
18.7.29,18.7.33,0.94612074
18.8.30,18.8.34,1
18.9.31,18.9.35,1
