_,13.7.27,0
_,13.11.31,0
1.1.1,1.1.1,1
2.1.2,2.1.2,1
3.1.3,3.1.3,1
4.1.4,4.1.4,1
5.1.5,5.1.5,1
6.1.6,6.1.6,1
7.1.7,7.1.7,1
7.2.8,7.2.8,1
7.3.9,7.3.9,1
7.4.10,7.4.10,1
7.5.11,7.5.11,0.7565892
7.6.12,7.6.12,1
7.7.13,7.7.13,1
8.1.14,8.1.14,1
9.1.15,9.1.15,1
10.1.16,10.1.16,1
10.2.17,10.2.17,1
10.3.18,10.3.18,1
11.1.19,11.1.19,1
12.1.20,12.1.20,0.99541986
13.1.21,13.1.21,1
13.2.22,13.2.22,1
13.3.23,13.3.23,1
13.4.24,13.4.24,1
13.5.25,13.5.25,1
13.6.26,13.6.26,1
13.7.27,13.8.28,1
13.8.28,13.9.29,1
13.9.29,13.10.30,1
13.10.30,13.12.32,1
14.1.31,14.1.33,1
14.2.32,14.2.34,1
14.3.33,14.3.35,1
14.4.34,14.4.36,1
14.5.35,14.5.37,0.9776596
