_,19.1.31,0
_,19.2.32,0
1.1.1,1.1.1,1
2.1.2,2.1.2,1
3.1.3,3.1.3,0.99471366
4.1.4,4.1.4,1
5.1.5,5.1.5,1
6.1.6,6.1.6,1
7.1.7,7.1.7,1
7.2.8,7.2.8,1
7.3.9,7.3.9,1
7.4.10,7.4.10,1
7.5.11,7.5.11,1
7.6.12,7.6.12,1
8.1.13,8.1.13,1
9.1.14,9.1.14,1
10.1.15,10.1.15,1
10.2.16,10.2.16,1
10.3.17,10.3.17,1
10.4.18,10.4.18,1
11.1.19,11.1.19,1
12.1.20,12.1.20,1
13.1.21,13.1.21,1
14.1.22,14.1.22,1
14.2.23,14.2.23,1
14.3.24,14.3.24,1
14.4.25,14.4.25,1
14.5.26,14.5.26,1
15.1.27,15.1.27,1
16.1.28,16.1.28,1
17.1.29,17.1.29,1
18.1.30,18.1.30,1
19.1.31,_,0
19.2.32,19.3.33,1
19.3.33,19.4.34,1
19.4.34,19.5.35,1
19.5.35,19.6.36,1
19.6.36,19.7.37,1
19.7.37,19.8.38,1
19.8.38,19.9.39,1
19.9.39,19.10.40,1
19.10.40,19.11.41,1
19.11.41,19.12.42,1
19.12.42,19.13.43,1
19.13.43,19.14.44,1
19.14.44,19.15.45,1
19.15.45,19.16.46,1
19.16.46,19.17.47,1
19.17.47,19.18.48,1
19.18.48,19.19.49,1
19.19.49,19.20.50,1
19.20.50,19.21.51,1
19.21.51,19.22.52,1
19.22.52,19.23.53,1
19.23.53,19.24.54,1
19.24.54,19.25.55,1
19.25.55,19.26.56,1
19.26.56,19.27.57,1
19.27.57,19.28.58,1
19.28.58,19.29.59,1
20.1.59,20.1.60,1
21.1.60,21.1.61,1
21.2.61,21.2.62,1
21.3.62,21.3.63,1
22.1.63,22.1.64,1
22.2.64,22.2.65,1
22.3.65,22.3.66,1
22.4.66,22.4.67,1
22.5.67,22.5.68,1
23.1.68,23.1.69,1
