1.1.1,1.1.1,1
2.1.2,2.1.2,1
3.1.3,3.1.3,1
4.1.4,4.1.4,1
5.1.5,5.1.5,1
6.1.6,6.1.6,1
7.1.7,7.1.7,1
7.2.8,7.2.8,1
7.3.9,7.3.9,1
7.4.10,7.4.10,1
7.5.11,7.5.11,1
8.1.12,8.1.12,1
8.2.13,8.2.13,1
8.3.14,8.3.14,1
8.4.15,8.4.15,1
9.1.16,9.1.16,1
10.1.17,10.1.17,1
11.1.18,11.1.18,1
11.2.19,11.2.19,1
11.3.20,11.3.20,1
11.4.21,11.4.21,1
11.5.22,11.5.22,1
12.1.23,12.1.23,1
12.2.24,12.2.24,1
12.3.25,12.3.25,1
13.1.26,13.1.26,1
14.1.27,14.1.27,1
15.1.28,15.1.28,1
15.2.29,15.2.29,1
15.3.30,15.3.30,1
16.1.31,16.1.31,1
17.1.32,17.1.32,1
17.2.33,17.2.33,1
17.3.34,17.3.34,1
17.4.35,17.4.35,1
17.5.36,17.5.36,1
17.6.37,17.6.37,1
17.7.38,17.7.38,1
18.1.39,18.1.39,1
