1.1.1,1.1.1,1
2.1.2,2.1.2,1
3.1.3,3.1.3,1
4.1.4,4.1.4,1
4.2.5,_,0
4.3.6,4.2.5,1
4.4.7,4.3.6,1
5.1.8,5.1.7,0.77784455
6.1.9,6.1.8,1
6.2.10,6.2.9,1
7.1.11,7.1.10,1
8.1.12,8.1.11,1
9.1.13,9.1.12,1
9.2.14,9.2.13,1
9.3.15,9.3.14,1
9.4.16,9.4.15,1
9.5.17,9.5.16,1
9.6.18,9.6.17,1
10.1.19,10.1.18,1
11.1.20,11.1.19,1
12.1.21,12.1.20,1
12.2.22,12.2.21,1
12.3.23,12.3.22,1
12.4.24,12.4.23,1
12.5.25,12.5.24,1
13.1.26,13.1.25,0.99520004
14.1.27,14.1.26,1
15.1.28,15.1.27,1
16.1.29,16.1.28,1
16.2.30,16.2.29,1
16.3.31,16.3.30,1
16.4.32,16.4.31,1
16.5.33,16.5.32,1
16.6.34,16.6.33,1
16.7.35,16.7.34,1
16.8.36,16.8.35,1
