1.1.1,1.1.1,1
2.1.2,2.1.2,1
3.1.3,3.1.3,1
4.1.4,4.1.4,1
5.1.5,5.1.5,1
6.1.6,6.1.6,1
7.1.7,7.1.7,1
8.1.8,8.1.8,1
9.1.9,9.1.9,1
10.1.10,10.1.10,1
11.1.11,11.1.11,1
12.1.12,12.1.12,1
13.1.13,13.1.13,1
13.2.14,13.2.14,1
13.3.15,13.3.15,1
13.4.16,13.4.16,1
13.5.17,13.5.17,1
14.1.18,14.1.18,1
15.1.19,15.1.19,1
16.1.20,16.1.20,1
17.1.21,17.1.21,1
18.1.22,18.1.22,1
19.1.23,19.1.23,1
20.1.24,20.1.24,1
21.1.25,21.1.25,1
22.1.26,22.1.26,1
22.2.27,22.2.27,1
22.3.28,22.3.28,1
22.4.29,22.4.29,1
22.5.30,22.5.30,0.74054056
