1.1.1,1.1.1,1
2.1.2,2.1.2,1
3.1.3,3.1.3,1
4.1.4,4.1.4,1
4.2.5,4.2.5,1
4.3.6,4.3.6,1
4.4.7,4.4.7,1
4.5.8,4.5.8,1
4.6.9,4.6.9,1
4.7.10,4.7.10,1
4.8.11,4.8.11,1
4.9.12,4.9.12,1
5.1.13,5.1.13,1
6.1.14,6.1.14,1
7.1.15,7.1.15,1
8.1.16,8.1.16,1
8.2.17,8.2.17,1
8.3.18,8.3.18,1
9.1.19,9.1.19,1
9.2.20,9.2.20,1
9.3.21,9.3.21,1
9.4.22,9.4.22,1
9.5.23,9.5.23,1
9.6.24,9.6.24,1
10.1.25,10.1.25,1
10.2.26,10.2.26,1
10.3.27,10.3.27,1
10.4.28,10.4.28,1
11.1.29,11.1.29,1
12.1.30,12.1.30,1
12.2.31,12.2.31,1
12.3.32,12.3.32,1
12.4.33,12.4.33,1
12.5.34,12.5.34,1
12.6.35,12.6.35,1
12.7.36,12.7.36,1
12.8.37,12.8.37,1
12.9.38,12.9.38,1
12.10.39,12.10.39,1
12.11.40,12.11.40,1
13.1.41,13.1.41,1
13.2.42,13.2.42,1
13.3.43,13.3.43,1
14.1.44,14.1.44,1
14.2.45,14.2.45,1
14.3.46,14.3.46,1
14.4.47,14.4.47,1
14.5.48,14.5.48,1
14.6.49,14.6.49,1
14.7.50,14.7.50,1
14.8.51,14.8.51,1
14.9.52,14.9.52,1
14.10.53,14.10.53,1
14.11.54,14.11.54,1
15.1.55,15.1.55,1
16.1.56,16.1.56,1
17.1.57,17.1.57,1
17.2.58,17.2.58,1
17.3.59,17.3.59,1
18.1.60,18.1.60,1
18.2.61,18.2.61,1
18.3.62,18.3.62,1
18.4.63,18.4.63,1
19.1.64,19.1.64,1
20.1.65,20.1.65,1
21.1.66,21.1.66,1
22.1.67,22.1.67,1
