1.1.1,1.1.1,1
2.1.2,2.1.2,1
3.1.3,3.1.3,1
4.1.4,4.1.4,1
5.1.5,5.1.5,1
6.1.6,6.1.6,1
7.1.7,7.1.7,1
8.1.8,8.1.8,1
9.1.9,9.1.9,1
10.1.10,10.1.10,1
11.1.11,11.1.11,1
11.2.12,11.2.12,1
11.3.13,11.3.13,1
11.4.14,11.4.14,1
12.1.15,12.1.15,1
13.1.16,13.1.16,1
14.1.17,14.1.17,1
14.2.18,14.2.18,1
14.3.19,14.3.19,1
14.4.20,14.4.20,1
15.1.21,15.1.21,1
16.1.22,16.1.22,1
17.1.23,17.1.23,1
17.2.24,17.2.24,1
17.3.25,17.3.25,1
17.4.26,17.4.26,1
18.1.27,18.1.27,1
19.1.28,19.1.28,1
19.2.29,19.2.29,1
19.3.30,19.3.30,1
19.4.31,19.4.31,1
19.5.32,19.5.32,1
19.6.33,19.6.33,1
19.7.34,19.7.34,1
19.8.35,19.8.35,1
20.1.36,20.1.36,1
21.1.37,21.1.37,1
22.1.38,22.1.38,1
22.2.39,22.2.39,1
23.1.40,23.1.40,1
24.1.41,24.1.41,1
25.1.42,25.1.42,1
26.1.43,26.1.43,1
26.2.44,26.2.44,1
27.1.45,27.1.45,1
28.1.46,28.1.46,1
29.1.47,29.1.47,1
29.2.48,29.2.48,1
29.3.49,29.3.49,1
29.4.50,29.4.50,1
30.1.51,30.1.51,1
