1.1.1,1.1.1,1
2.1.2,2.1.2,1
3.1.3,3.1.3,1
4.1.4,4.1.4,1
5.1.5,5.1.5,1
6.1.6,6.1.6,1
7.1.7,7.1.7,1
7.2.8,7.2.8,1
7.3.9,7.3.9,1
7.4.10,7.4.10,1
7.5.11,7.5.11,1
7.6.12,7.6.12,1
7.7.13,7.7.13,1
8.1.14,8.1.14,1
9.1.15,9.1.15,1
10.1.16,10.1.16,1
11.1.17,11.1.17,1
11.2.18,11.2.18,1
11.3.19,11.3.19,1
12.1.20,12.1.20,1
13.1.21,13.1.21,1
14.1.22,14.1.22,1
14.2.23,14.2.23,1
15.1.24,15.1.24,1
16.1.25,16.1.25,1
16.2.26,16.2.26,1
16.3.27,16.3.27,1
16.4.28,16.4.28,1
16.5.29,16.5.29,1
16.6.30,16.6.30,1
16.7.31,16.7.31,1
16.8.32,16.8.32,1
