_,1.1.1,0
_,1.2.2,0
_,1.3.3,0
_,1.4.4,0
_,1.5.5,0
1.1.1,_,0
2.1.2,2.1.6,1
3.1.3,3.1.7,1
4.1.4,4.1.8,1
5.1.5,5.1.9,0.88309944
6.1.6,6.1.10,1
6.2.7,6.2.11,1
6.3.8,6.3.12,1
6.4.9,6.4.13,1
6.5.10,6.5.14,1
7.1.11,7.1.15,0.9945946
8.1.12,8.1.16,1
8.2.13,8.2.17,1
9.1.14,9.1.18,1
10.1.15,10.1.19,1
11.1.16,11.1.20,1
11.2.17,11.2.21,1
11.3.18,11.3.22,1
11.4.19,11.4.23,1
11.5.20,11.5.24,1
11.6.21,11.6.25,1
11.7.22,11.7.26,1
11.8.23,11.8.27,1
11.9.24,11.9.28,1
12.1.25,12.1.29,0.890911
13.1.26,13.1.30,0.9690571
13.2.27,13.2.31,1
13.3.28,13.3.32,1
13.4.29,13.4.33,1
13.5.30,13.5.34,1
14.1.31,14.1.35,1
15.1.32,15.1.36,1
15.2.33,15.2.37,1
15.3.34,15.3.38,1
