_,2.1.6,0
_,11.1.23,0
_,12.1.24,0
_,12.2.25,0
_,12.3.26,0
_,12.4.27,0
_,12.5.28,0
_,12.6.29,0
_,12.7.30,0
_,12.8.31,0
_,12.9.32,0
_,12.10.33,0
_,18.1.50,0
1.1.1,1.1.1,1
1.2.2,1.2.2,1
1.3.3,1.3.3,1
1.4.4,1.4.4,1
1.5.5,1.5.5,1
2.1.6,_,0
3.1.7,3.1.7,1
4.1.8,4.1.8,1
5.1.9,5.1.9,1
6.1.10,6.1.10,1
7.1.11,7.1.11,1
8.1.12,8.1.12,1
8.2.13,8.2.13,1
8.3.14,8.3.14,1
9.1.15,9.1.15,1
9.2.16,9.2.16,1
9.3.17,9.3.17,1
9.4.18,9.4.18,1
9.5.19,9.5.19,1
10.1.20,10.1.20,1
10.2.21,10.2.21,1
10.3.22,10.3.22,1
11.1.23,13.1.34,1
12.1.24,14.1.35,1
13.1.25,15.1.36,1
13.2.26,15.2.37,1
13.3.27,15.3.38,1
13.4.28,15.4.39,1
13.5.29,15.5.40,1
13.6.30,15.6.41,1
14.1.31,16.1.42,1
15.1.32,17.1.43,1
15.2.33,17.2.44,1
15.3.34,17.3.45,1
15.4.35,17.4.46,1
15.5.36,17.5.47,1
15.6.37,17.6.48,1
15.7.38,17.7.49,1
16.1.39,19.1.51,1
17.1.40,20.1.52,1
