1.1.1,1.1.1,1
1.2.2,1.2.2,1
1.3.3,1.3.3,1
1.4.4,1.4.4,1
1.5.5,1.5.5,1
2.1.6,2.1.6,1
3.1.7,3.1.7,1
4.1.8,4.1.8,1
4.2.9,4.2.9,1
5.1.10,5.1.10,1
6.1.11,6.1.11,1
6.2.12,6.2.12,1
7.1.13,7.1.13,1
7.2.14,7.2.14,1
8.1.15,8.1.15,1
8.2.16,8.2.16,1
9.1.17,9.1.17,1
10.1.18,10.1.18,1
10.2.19,10.2.19,1
11.1.20,11.1.20,1
12.1.21,12.1.21,1
12.2.22,12.2.22,1
13.1.23,13.1.23,1
14.1.24,14.1.24,1
14.2.25,14.2.25,1
15.1.26,15.1.26,1
15.2.27,15.2.27,1
16.1.28,16.1.28,1
17.1.29,17.1.29,1
17.2.30,17.2.30,1
17.3.31,17.3.31,1
17.4.32,17.4.32,1
17.5.33,17.5.33,1
18.1.34,18.1.34,1
18.2.35,18.2.35,1
18.3.36,18.3.36,1
19.1.37,19.1.37,1
19.2.38,19.2.38,1
20.1.39,20.1.39,1
20.2.40,20.2.40,1
