1.1.1,1.1.1,1
1.2.2,1.2.2,1
1.3.3,1.3.3,1
1.4.4,1.4.4,1
1.5.5,1.5.5,1
2.1.6,2.1.6,1
3.1.7,3.1.7,1
4.1.8,4.1.8,1
4.2.9,4.2.9,1
4.3.10,4.3.10,1
5.1.11,5.1.11,1
5.2.12,5.2.12,1
5.3.13,5.3.13,1
6.1.14,6.1.14,1
7.1.15,7.1.15,1
8.1.16,_,0
8.2.17,8.1.16,1
8.3.18,_,0
9.1.19,9.1.17,1
10.1.20,_,0
10.2.21,10.1.18,1
10.3.22,10.2.19,1
10.4.23,10.3.20,1
10.5.24,10.4.21,1
10.6.25,10.5.22,1
10.7.26,10.6.23,1
10.8.27,10.7.24,1
10.9.28,10.8.25,1
10.10.29,10.9.26,1
10.11.30,10.10.27,1
10.12.31,10.11.28,1
10.13.32,10.12.29,1
10.14.33,10.13.30,1
10.15.34,_,0
11.1.35,11.1.31,1
11.2.36,11.2.32,1
11.3.37,11.3.33,1
12.1.38,12.1.34,1
13.1.39,13.1.35,1
14.1.40,_,0
14.2.41,14.1.36,1
14.3.42,14.2.37,1
14.4.43,14.3.38,1
14.5.44,14.4.39,1
14.6.45,14.5.40,1
14.7.46,14.6.41,1
14.8.47,_,0
15.1.48,15.1.42,1
16.1.49,_,0
16.2.50,16.1.43,1
16.3.51,_,0
17.1.52,17.1.44,1
17.2.53,17.2.45,1
17.3.54,17.3.46,1
17.4.55,17.4.47,1
17.5.56,17.5.48,1
17.6.57,17.6.49,1
17.7.58,17.7.50,1
