_,17.1.33,0
1.1.1,1.1.1,1
2.1.2,2.1.2,1
3.1.3,3.1.3,1
3.2.4,3.2.4,1
3.3.5,3.3.5,1
4.1.6,4.1.6,1
5.1.7,5.1.7,1
6.1.8,6.1.8,1
7.1.9,7.1.9,1
7.2.10,7.2.10,1
7.3.11,7.3.11,1
8.1.12,8.1.12,1
9.1.13,9.1.13,1
9.2.14,9.2.14,1
9.3.15,9.3.15,1
9.4.16,9.4.16,1
9.5.17,9.5.17,1
10.1.18,10.1.18,1
11.1.19,11.1.19,1
12.1.20,12.1.20,1
13.1.21,13.1.21,1
14.1.22,14.1.22,1
14.2.23,14.2.23,1
14.3.24,14.3.24,1
14.4.25,14.4.25,1
14.5.26,14.5.26,1
14.6.27,14.6.27,1
14.7.28,14.7.28,1
14.8.29,14.8.29,1
14.9.30,14.9.30,1
15.1.31,15.1.31,1
16.1.32,16.1.32,1
17.1.33,17.2.34,1
17.2.34,17.3.35,1
17.3.35,17.4.36,1
17.4.36,17.5.37,1
18.1.37,18.1.38,0.9371728
