1.1.1,1.1.1,1
1.2.2,1.2.2,1
1.3.3,1.3.3,1
1.4.4,1.4.4,1
1.5.5,1.5.5,1
2.1.6,2.1.6,1
3.1.7,3.1.7,1
4.1.8,4.1.8,1
5.1.9,5.1.9,1
6.1.10,6.1.10,1
7.1.11,7.1.11,1
7.2.12,7.2.12,1
7.3.13,7.3.13,1
7.4.14,7.4.14,1
7.5.15,7.5.15,1
7.6.16,7.6.16,1
8.1.17,8.1.17,1
9.1.18,9.1.18,1
10.1.19,10.1.19,1
10.2.20,10.2.20,1
10.3.21,10.3.21,1
10.4.22,10.4.22,1
11.1.23,11.1.23,1
11.2.24,11.2.24,1
11.3.25,11.3.25,1
12.1.26,12.1.26,1
13.1.27,13.1.27,1
14.1.28,14.1.28,1
15.1.29,15.1.29,1
15.2.30,15.2.30,1
16.1.31,16.1.31,1
16.2.32,16.2.32,1
17.1.33,17.1.33,1
17.2.34,17.2.34,1
17.3.35,17.3.35,1
18.1.36,18.1.36,1
18.2.37,_,0
18.3.38,18.2.37,0.657205
18.4.39,18.3.38,1
