1.1.1,1.1.1,1
2.1.2,2.1.2,1
3.1.3,3.1.3,1
4.1.4,4.1.4,1
5.1.5,5.1.5,1
6.1.6,6.1.6,1
7.1.7,7.1.7,1
8.1.8,8.1.8,1
9.1.9,9.1.9,1
10.1.10,10.1.10,1
11.1.11,11.1.11,1
12.1.12,12.1.12,1
13.1.13,13.1.13,1
14.1.14,14.1.14,1
15.1.15,15.1.15,1
16.1.16,16.1.16,1
16.2.17,16.2.17,1
17.1.18,17.1.18,1
18.1.19,18.1.19,1
18.2.20,18.2.20,1
18.3.21,18.3.21,1
18.4.22,18.4.22,1
18.5.23,18.5.23,1
18.6.24,18.6.24,1
18.7.25,18.7.25,1
18.8.26,18.8.26,1
18.9.27,18.9.27,1
18.10.28,18.10.28,1
18.11.29,18.11.29,1
18.12.30,18.12.30,1
19.1.31,19.1.31,1
20.1.32,20.1.32,1
21.1.33,21.1.33,1
22.1.34,22.1.34,1
22.2.35,22.2.35,1
22.3.36,22.3.36,0.9943396
22.4.37,22.4.37,1
22.5.38,22.5.38,1
23.1.39,23.1.39,1
