1.1.1,1.1.1,1
1.2.2,1.2.2,1
1.3.3,1.3.3,1
1.4.4,1.4.4,1
1.5.5,1.5.5,1
2.1.6,2.1.6,1
3.1.7,3.1.7,1
4.1.8,4.1.8,1
5.1.9,5.1.9,0.9971963
5.2.10,5.2.10,1
5.3.11,5.3.11,1
6.1.12,6.1.12,1
6.2.13,6.2.13,1
6.3.14,6.3.14,1
7.1.15,7.1.15,1
7.2.16,7.2.16,1
7.3.17,7.3.17,1
7.4.18,7.4.18,1
7.5.19,7.5.19,1
8.1.20,8.1.20,1
9.1.21,9.1.21,1
10.1.22,10.1.22,1
11.1.23,11.1.23,1
12.1.24,12.1.24,1
12.2.25,12.2.25,1
12.3.26,12.3.26,1
12.4.27,12.4.27,1
12.5.28,12.5.28,1
12.6.29,12.6.29,1
12.7.30,12.7.30,1
13.1.31,13.1.31,1
14.1.32,14.1.32,1
15.1.33,15.1.33,1
16.1.34,16.1.34,1
17.1.35,17.1.35,1
18.1.36,18.1.36,1
18.2.37,18.2.37,1
18.3.38,18.3.38,1
18.4.39,18.4.39,1
18.5.40,18.5.40,0.99769235
