_,7.5.11,0
1.1.1,1.1.1,1
2.1.2,2.1.2,1
3.1.3,3.1.3,1
4.1.4,4.1.4,1
5.1.5,5.1.5,0.8986891
6.1.6,_,0
7.1.7,6.1.6,1
8.1.8,7.1.7,1
8.2.9,7.2.8,1
8.3.10,7.3.9,1
8.4.11,7.4.10,1
8.5.12,_,0
8.6.13,7.6.12,1
8.7.14,7.7.13,1
9.1.15,8.1.14,1
10.1.16,9.1.15,1
11.1.17,10.1.16,1
12.1.18,11.1.17,1
12.2.19,11.2.18,0.8841202
12.3.20,11.3.19,1
13.1.21,12.1.20,1
14.1.22,13.1.21,1
15.1.23,14.1.22,1
15.2.24,14.2.23,1
16.1.25,15.1.24,1
17.1.26,16.1.25,1
17.2.27,16.2.26,1
17.3.28,16.3.27,1
17.4.29,16.4.28,1
17.5.30,16.5.29,1
17.6.31,16.6.30,1
17.7.32,16.7.31,1
17.8.33,16.8.32,1
