_,8.5.12,0
1.1.1,1.1.1,1
2.1.2,2.1.2,1
3.1.3,3.1.3,1
4.1.4,4.1.4,1
5.1.5,5.1.5,1
6.1.6,6.1.6,0.921504
7.1.7,_,0
8.1.8,7.1.7,1
9.1.9,8.1.8,1
9.2.10,8.2.9,1
9.3.11,8.3.10,1
9.4.12,8.4.11,1
9.5.13,_,0
9.6.14,8.6.13,1
9.7.15,8.7.14,1
10.1.16,9.1.15,1
11.1.17,10.1.16,1
12.1.18,11.1.17,1
13.1.19,12.1.18,1
13.2.20,12.2.19,0.8841202
13.3.21,12.3.20,1
14.1.22,13.1.21,1
15.1.23,14.1.22,1
16.1.24,15.1.23,1
16.2.25,15.2.24,1
17.1.26,16.1.25,1
18.1.27,17.1.26,1
18.2.28,17.2.27,1
18.3.29,17.3.28,1
18.4.30,17.4.29,1
18.5.31,17.5.30,1
18.6.32,17.6.31,1
18.7.33,17.7.32,1
18.8.34,17.8.33,1
