1.1.1,1.1.1,1
2.1.2,2.1.2,1
3.1.3,3.1.3,1
4.1.4,4.1.4,1
4.2.5,4.2.5,1
4.3.6,4.3.6,1
5.1.7,5.1.7,1
6.1.8,6.1.8,1
7.1.9,7.1.9,1
7.2.10,7.2.10,1
7.3.11,7.3.11,1
7.4.12,7.4.12,1
7.5.13,7.5.13,1
7.6.14,7.6.14,1
7.7.15,7.7.15,1
7.8.16,7.8.16,1
8.1.17,8.1.17,1
9.1.18,9.1.18,1
10.1.19,10.1.19,1
11.1.20,11.1.20,1
11.2.21,11.2.21,1
11.3.22,11.3.22,1
11.4.23,11.4.23,1
11.5.24,11.5.24,1
11.6.25,11.6.25,1
11.7.26,11.7.26,1
12.1.27,12.1.27,1
13.1.28,13.1.28,1
13.2.29,13.2.29,1
13.3.30,13.3.30,0.9739131
13.4.31,13.4.31,1
13.5.32,13.5.32,1
14.1.33,14.1.33,1
