_,1.1.1,0
1.1.1,2.1.2,1
2.1.2,3.1.3,1
3.1.3,4.1.4,1
4.1.4,5.1.5,1
5.1.5,6.1.6,1
6.1.6,7.1.7,1
6.2.7,7.2.8,1
7.1.8,8.1.9,1
8.1.9,9.1.10,1
8.2.10,9.2.11,1
8.3.11,9.3.12,1
9.1.12,10.1.13,1
10.1.13,11.1.14,1
11.1.14,12.1.15,1
11.2.15,12.2.16,1
11.3.16,12.3.17,1
11.4.17,12.4.18,1
11.5.18,12.5.19,1
12.1.19,13.1.20,1
13.1.20,14.1.21,1
14.1.21,15.1.22,1
15.1.22,16.1.23,1
15.2.23,16.2.24,1
16.1.24,17.1.25,1
17.1.25,18.1.26,1
17.2.26,18.2.27,1
17.3.27,18.3.28,1
17.4.28,18.4.29,1
17.5.29,18.5.30,1
18.1.30,19.1.31,1
19.1.31,20.1.32,1
19.2.32,20.2.33,1
19.3.33,20.3.34,1
19.4.34,20.4.35,1
19.5.35,20.5.36,1
19.6.36,20.6.37,1
20.1.37,21.1.38,1
21.1.38,22.1.39,1
21.2.39,22.2.40,1
21.3.40,22.3.41,1
21.4.41,22.4.42,1
21.5.42,22.5.43,1
21.6.43,22.6.44,1
22.1.44,23.1.45,1
23.1.45,24.1.46,1
24.1.46,25.1.47,1
25.1.47,26.1.48,1
25.2.48,26.2.49,1
26.1.49,27.1.50,1
