_,1.1.1,0
1.1.1,2.1.2,1
2.1.2,3.1.3,1
3.1.3,4.1.4,1
4.1.4,5.1.5,1
5.1.5,6.1.6,1
6.1.6,7.1.7,1
6.2.7,7.2.8,1
7.1.8,8.1.9,1
8.1.9,9.1.10,1
8.2.10,9.2.11,1
8.3.11,9.3.12,1
8.4.12,9.4.13,1
8.5.13,9.5.14,1
9.1.14,10.1.15,1
10.1.15,11.1.16,1
11.1.16,12.1.17,1
12.1.17,13.1.18,1
13.1.18,14.1.19,1
14.1.19,15.1.20,1
15.1.20,16.1.21,1
16.1.21,17.1.22,1
16.2.22,17.2.23,1
16.3.23,17.3.24,1
16.4.24,17.4.25,1
16.5.25,17.5.26,1
16.6.26,17.6.27,1
16.7.27,17.7.28,1
16.8.28,17.8.29,1
16.9.29,17.9.30,1
