_,1.1.1,0
1.1.1,2.1.2,1
2.1.2,3.1.3,1
3.1.3,4.1.4,1
4.1.4,5.1.5,1
4.2.5,5.2.6,1
4.3.6,5.3.7,1
4.4.7,5.4.8,1
4.5.8,5.5.9,1
4.6.9,5.6.10,1
4.7.10,5.7.11,1
4.8.11,5.8.12,1
5.1.12,6.1.13,1
6.1.13,7.1.14,1
7.1.14,8.1.15,1
8.1.15,9.1.16,1
8.2.16,9.2.17,1
9.1.17,10.1.18,1
10.1.18,11.1.19,1
11.1.19,12.1.20,1
11.2.20,12.2.21,1
11.3.21,12.3.22,1
11.4.22,12.4.23,1
11.5.23,12.5.24,1
11.6.24,12.6.25,1
11.7.25,12.7.26,1
11.8.26,12.8.27,1
11.9.27,12.9.28,1
12.1.28,13.1.29,1
13.1.29,14.1.30,1
14.1.30,15.1.31,1
15.1.31,16.1.32,1
15.2.32,16.2.33,1
15.3.33,16.3.34,1
15.4.34,16.4.35,1
