_,1.1.1,0
1.1.1,2.1.2,1
2.1.2,3.1.3,1
3.1.3,4.1.4,1
4.1.4,5.1.5,1
5.1.5,6.1.6,1
5.2.6,6.2.7,1
5.3.7,6.3.8,1
5.4.8,6.4.9,1
5.5.9,6.5.10,1
5.6.10,6.6.11,1
6.1.11,7.1.12,1
7.1.12,8.1.13,1
8.1.13,9.1.14,1
9.1.14,10.1.15,1
9.2.15,10.2.16,1
9.3.16,10.3.17,1
10.1.17,11.1.18,1
10.2.18,11.2.19,1
10.3.19,11.3.20,1
10.4.20,11.4.21,1
10.5.21,11.5.22,1
11.1.22,12.1.23,1
11.2.23,12.2.24,1
11.3.24,12.3.25,1
11.4.25,12.4.26,1
11.5.26,12.5.27,1
11.6.27,12.6.28,1
11.7.28,12.7.29,1
12.1.29,13.1.30,1
13.1.30,14.1.31,1
14.1.31,15.1.32,1
14.2.32,15.2.33,1
14.3.33,15.3.34,1
14.4.34,15.4.35,1
14.5.35,15.5.36,1
14.6.36,15.6.37,1
14.7.37,15.7.38,1
14.8.38,15.8.39,1
14.9.39,15.9.40,1
14.10.40,15.10.41,1
14.11.41,15.11.42,1
14.12.42,15.12.43,1
14.13.43,15.13.44,1
14.14.44,15.14.45,1
14.15.45,15.15.46,1
14.16.46,15.16.47,1
14.17.47,15.17.48,1
15.1.48,16.1.49,1
