_,1.1.1,0
1.1.1,2.1.2,1
2.1.2,3.1.3,1
3.1.3,4.1.4,1
4.1.4,5.1.5,1
5.1.5,6.1.6,1
6.1.6,7.1.7,1
7.1.7,8.1.8,1
8.1.8,9.1.9,1
8.2.9,9.2.10,1
8.3.10,9.3.11,1
8.4.11,9.4.12,1
8.5.12,9.5.13,1
9.1.13,10.1.14,1
10.1.14,11.1.15,1
10.2.15,11.2.16,1
11.1.16,12.1.17,1
12.1.17,13.1.18,1
12.2.18,13.2.19,1
12.3.19,13.3.20,1
13.1.20,14.1.21,1
14.1.21,15.1.22,1
15.1.22,16.1.23,1
15.2.23,16.2.24,1
16.1.24,17.1.25,1
17.1.25,18.1.26,1
17.2.26,18.2.27,1
17.3.27,18.3.28,1
17.4.28,18.4.29,1
17.5.29,18.5.30,1
17.6.30,18.6.31,1
17.7.31,18.7.32,1
17.8.32,18.8.33,1
