_,1.1.1,0
1.1.1,2.1.2,1
2.1.2,3.1.3,1
3.1.3,4.1.4,1
4.1.4,5.1.5,1
5.1.5,6.1.6,1
6.1.6,7.1.7,1
6.2.7,7.2.8,1
6.3.8,7.3.9,1
6.4.9,7.4.10,1
7.1.10,8.1.11,1
8.1.11,9.1.12,1
8.2.12,9.2.13,1
9.1.13,10.1.14,1
10.1.14,11.1.15,1
11.1.15,12.1.16,1
11.2.16,12.2.17,1
11.3.17,12.3.18,1
11.4.18,12.4.19,1
11.5.19,12.5.20,1
11.6.20,12.6.21,1
12.1.21,13.1.22,1
13.1.22,14.1.23,1
14.1.23,15.1.24,1
14.2.24,15.2.25,1
14.3.25,15.3.26,1
14.4.26,15.4.27,1
14.5.27,15.5.28,1
15.1.28,16.1.29,1
16.1.29,17.1.30,1
17.1.30,18.1.31,1
18.1.31,19.1.32,1
18.2.32,19.2.33,1
18.3.33,19.3.34,1
18.4.34,19.4.35,1
18.5.35,19.5.36,1
18.6.36,19.6.37,1
18.7.37,19.7.38,1
18.8.38,19.8.39,1
