_,1.1.1,0
1.1.1,2.1.2,1
2.1.2,3.1.3,1
3.1.3,4.1.4,1
4.1.4,5.1.5,1
5.1.5,6.1.6,1
6.1.6,7.1.7,1
7.1.7,8.1.8,1
8.1.8,9.1.9,1
9.1.9,10.1.10,1
10.1.10,11.1.11,1
11.1.11,12.1.12,1
12.1.12,13.1.13,1
13.1.13,14.1.14,1
14.1.14,15.1.15,1
14.2.15,15.2.16,1
14.3.16,15.3.17,1
14.4.17,15.4.18,1
14.5.18,15.5.19,1
15.1.19,16.1.20,1
16.1.20,17.1.21,1
17.1.21,18.1.22,1
17.2.22,18.2.23,1
18.1.23,19.1.24,1
19.1.24,20.1.25,1
20.1.25,21.1.26,1
20.2.26,21.2.27,1
21.1.27,22.1.28,1
22.1.28,23.1.29,1
23.1.29,24.1.30,1
23.2.30,24.2.31,1
24.1.31,25.1.32,1
