_,1.1.1,0
1.1.1,2.1.2,1
2.1.2,3.1.3,1
3.1.3,4.1.4,1
4.1.4,5.1.5,1
5.1.5,6.1.6,1
6.1.6,7.1.7,1
6.2.7,7.2.8,1
6.3.8,7.3.9,1
6.4.9,7.4.10,1
6.5.10,7.5.11,1
7.1.11,8.1.12,1
8.1.12,9.1.13,1
9.1.13,10.1.14,1
9.2.14,10.2.15,1
10.1.15,11.1.16,1
11.1.16,12.1.17,1
11.2.17,12.2.18,1
11.3.18,12.3.19,1
12.1.19,13.1.20,1
13.1.20,14.1.21,1
14.1.21,15.1.22,1
15.1.22,16.1.23,1
15.2.23,16.2.24,1
15.3.24,16.3.25,1
16.1.25,17.1.26,1
16.2.26,17.2.27,1
16.3.27,17.3.28,1
16.4.28,17.4.29,1
16.5.29,17.5.30,1
16.6.30,17.6.31,1
17.1.31,18.1.32,1
18.1.32,19.1.33,1
18.2.33,19.2.34,1
19.1.34,20.1.35,1
