_,1.1.1,0
1.1.1,2.1.2,1
2.1.2,3.1.3,1
3.1.3,4.1.4,1
4.1.4,5.1.5,1
5.1.5,6.1.6,1
6.1.6,7.1.7,1
7.1.7,8.1.8,1
7.2.8,8.2.9,1
7.3.9,8.3.10,1
7.4.10,8.4.11,1
7.5.11,8.5.12,1
7.6.12,8.6.13,1
8.1.13,9.1.14,1
9.1.14,10.1.15,1
10.1.15,11.1.16,1
10.2.16,11.2.17,1
10.3.17,11.3.18,1
10.4.18,11.4.19,1
11.1.19,12.1.20,1
12.1.20,13.1.21,1
13.1.21,14.1.22,1
14.1.22,15.1.23,1
14.2.23,15.2.24,1
14.3.24,15.3.25,1
14.4.25,15.4.26,1
14.5.26,15.5.27,1
15.1.27,16.1.28,1
16.1.28,17.1.29,1
17.1.29,18.1.30,1
18.1.30,19.1.31,1
19.1.31,20.1.32,1
19.2.32,20.2.33,1
19.3.33,20.3.34,1
19.4.34,20.4.35,1
19.5.35,20.5.36,1
19.6.36,20.6.37,1
19.7.37,20.7.38,1
19.8.38,20.8.39,1
19.9.39,20.9.40,1
19.10.40,20.10.41,1
19.11.41,20.11.42,1
19.12.42,20.12.43,1
19.13.43,20.13.44,1
19.14.44,20.14.45,1
19.15.45,20.15.46,1
19.16.46,20.16.47,1
19.17.47,20.17.48,1
19.18.48,20.18.49,1
19.19.49,20.19.50,1
19.20.50,20.20.51,1
19.21.51,20.21.52,1
19.22.52,20.22.53,1
19.23.53,20.23.54,1
19.24.54,20.24.55,1
19.25.55,20.25.56,1
19.26.56,20.26.57,1
19.27.57,20.27.58,1
19.28.58,20.28.59,1
19.29.59,20.29.60,1
20.1.60,21.1.61,1
21.1.61,22.1.62,1
21.2.62,22.2.63,1
21.3.63,22.3.64,1
22.1.64,23.1.65,1
22.2.65,23.2.66,1
22.3.66,23.3.67,1
22.4.67,23.4.68,1
22.5.68,23.5.69,1
23.1.69,24.1.70,1
