_,1.1.1,0
1.1.1,2.1.2,1
2.1.2,3.1.3,1
3.1.3,4.1.4,1
4.1.4,5.1.5,1
5.1.5,6.1.6,1
5.2.6,6.2.7,1
5.3.7,6.3.8,1
6.1.8,7.1.9,1
7.1.9,8.1.10,1
8.1.10,9.1.11,1
8.2.11,9.2.12,1
8.3.12,9.3.13,1
8.4.13,9.4.14,1
8.5.14,9.5.15,1
8.6.15,9.6.16,1
8.7.16,9.7.17,1
9.1.17,10.1.18,1
9.2.18,10.2.19,1
9.3.19,10.3.20,1
9.4.20,10.4.21,1
9.5.21,10.5.22,1
9.6.22,10.6.23,1
10.1.23,11.1.24,1
11.1.24,12.1.25,1
12.1.25,13.1.26,1
13.1.26,14.1.27,1
13.2.27,14.2.28,1
13.3.28,14.3.29,1
13.4.29,14.4.30,1
13.5.30,14.5.31,1
13.6.31,14.6.32,1
13.7.32,14.7.33,1
14.1.33,15.1.34,1
15.1.34,16.1.35,1
15.2.35,16.2.36,1
15.3.36,16.3.37,1
15.4.37,16.4.38,1
15.5.38,16.5.39,1
15.6.39,16.6.40,1
15.7.40,16.7.41,1
16.1.41,17.1.42,1
17.1.42,18.1.43,1
18.1.43,19.1.44,1
18.2.44,19.2.45,1
18.3.45,19.3.46,1
