_,1.1.1,0
1.1.1,2.1.2,1
2.1.2,3.1.3,1
3.1.3,4.1.4,1
3.2.4,4.2.5,1
4.1.5,5.1.6,1
5.1.6,6.1.7,1
6.1.7,7.1.8,1
7.1.8,8.1.9,1
8.1.9,9.1.10,1
8.2.10,9.2.11,1
8.3.11,9.3.12,1
9.1.12,10.1.13,1
10.1.13,11.1.14,1
11.1.14,12.1.15,1
12.1.15,13.1.16,1
12.2.16,13.2.17,1
13.1.17,14.1.18,1
13.2.18,14.2.19,1
13.3.19,14.3.20,1
13.4.20,14.4.21,1
13.5.21,14.5.22,1
13.6.22,14.6.23,1
13.7.23,14.7.24,1
13.8.24,14.8.25,1
13.9.25,14.9.26,1
13.10.26,14.10.27,1
13.11.27,14.11.28,1
14.1.28,15.1.29,1
14.2.29,15.2.30,1
14.3.30,15.3.31,1
14.4.31,15.4.32,1
14.5.32,15.5.33,1
14.6.33,15.6.34,1
14.7.34,15.7.35,1
14.8.35,15.8.36,1
14.9.36,15.9.37,1
14.10.37,15.10.38,1
14.11.38,15.11.39,1
14.12.39,15.12.40,1
14.13.40,15.13.41,1
14.14.41,15.14.42,1
14.15.42,15.15.43,1
14.16.43,15.16.44,1
14.17.44,15.17.45,1
14.18.45,15.18.46,1
14.19.46,15.19.47,1
15.1.47,16.1.48,1
16.1.48,17.1.49,1
16.2.49,17.2.50,1
17.1.50,18.1.51,1
18.1.51,19.1.52,1
19.1.52,20.1.53,1
20.1.53,21.1.54,1
20.2.54,21.2.55,1
20.3.55,21.3.56,1
20.4.56,21.4.57,1
20.5.57,21.5.58,1
20.6.58,21.6.59,1
21.1.59,22.1.60,1
21.2.60,22.2.61,1
21.3.61,22.3.62,1
21.4.62,22.4.63,1
21.5.63,22.5.64,1
21.6.64,22.6.65,1
21.7.65,22.7.66,1
21.8.66,22.8.67,1
22.1.67,23.1.68,1
22.2.68,23.2.69,1
22.3.69,23.3.70,1
23.1.70,24.1.71,1
23.2.71,24.2.72,1
23.3.72,24.3.73,1
