_,1.1.1,0
1.1.1,2.1.2,1
2.1.2,3.1.3,1
3.1.3,4.1.4,1
3.2.4,4.2.5,1
4.1.5,5.1.6,1
4.2.6,5.2.7,1
4.3.7,5.3.8,1
4.4.8,5.4.9,1
4.5.9,5.5.10,1
4.6.10,5.6.11,1
4.7.11,5.7.12,1
5.1.12,6.1.13,1
5.2.13,6.2.14,1
6.1.14,7.1.15,1
6.2.15,7.2.16,1
7.1.16,8.1.17,1
7.2.17,8.2.18,1
8.1.18,9.1.19,1
9.1.19,10.1.20,1
9.2.20,10.2.21,1
10.1.21,11.1.22,1
10.2.22,11.2.23,1
10.3.23,11.3.24,1
10.4.24,11.4.25,1
10.5.25,11.5.26,1
10.6.26,11.6.27,1
10.7.27,11.7.28,1
10.8.28,11.8.29,1
10.9.29,11.9.30,1
11.1.30,12.1.31,1
11.2.31,12.2.32,1
11.3.32,12.3.33,1
12.1.33,13.1.34,1
12.2.34,13.2.35,1
13.1.35,14.1.36,1
14.1.36,15.1.37,1
14.2.37,15.2.38,1
15.1.38,16.1.39,1
15.2.39,16.2.40,1
