_,1.1.1,0
1.1.1,2.1.2,1
2.1.2,3.1.3,1
3.1.3,4.1.4,1
4.1.4,5.1.5,1
4.2.5,5.2.6,1
5.1.6,6.1.7,1
6.1.7,7.1.8,1
7.1.8,8.1.9,1
7.2.9,8.2.10,1
7.3.10,8.3.11,1
7.4.11,8.4.12,1
7.5.12,8.5.13,1
7.6.13,8.6.14,1
8.1.14,9.1.15,1
9.1.15,10.1.16,1
10.1.16,11.1.17,1
10.2.17,11.2.18,1
11.1.18,12.1.19,1
12.1.19,13.1.20,1
13.1.20,14.1.21,1
13.2.21,14.2.22,1
13.3.22,14.3.23,1
13.4.23,14.4.24,1
13.5.24,14.5.25,1
14.1.25,15.1.26,1
14.2.26,15.2.27,1
14.3.27,15.3.28,1
14.4.28,15.4.29,1
15.1.29,16.1.30,1
16.1.30,17.1.31,1
17.1.31,18.1.32,1
18.1.32,19.1.33,1
19.1.33,20.1.34,1
19.2.34,20.2.35,1
19.3.35,20.3.36,1
19.4.36,20.4.37,1
19.5.37,20.5.38,1
19.6.38,20.6.39,1
19.7.39,20.7.40,1
19.8.40,20.8.41,1
19.9.41,20.9.42,1
19.10.42,20.10.43,1
20.1.43,21.1.44,1
21.1.44,22.1.45,1
21.2.45,22.2.46,1
21.3.46,22.3.47,1
21.4.47,22.4.48,1
21.5.48,22.5.49,1
21.6.49,22.6.50,1
21.7.50,22.7.51,1
