_,1.1.1,0
1.1.1,2.1.2,1
2.1.2,3.1.3,1
3.1.3,4.1.4,1
4.1.4,5.1.5,1
4.2.5,5.2.6,1
4.3.6,5.3.7,1
4.4.7,5.4.8,1
4.5.8,5.5.9,1
5.1.9,6.1.10,1
5.2.10,6.2.11,1
5.3.11,6.3.12,1
6.1.12,7.1.13,1
7.1.13,8.1.14,1
7.2.14,8.2.15,1
7.3.15,8.3.16,1
8.1.16,9.1.17,1
9.1.17,10.1.18,1
9.2.18,10.2.19,1
9.3.19,10.3.20,1
10.1.20,11.1.21,1
10.2.21,11.2.22,1
10.3.22,11.3.23,1
10.4.23,11.4.24,1
10.5.24,11.5.25,1
11.1.25,12.1.26,1
12.1.26,13.1.27,1
12.2.27,13.2.28,1
12.3.28,13.3.29,1
12.4.29,13.4.30,1
12.5.30,13.5.31,1
12.6.31,13.6.32,1
13.1.32,14.1.33,1
14.1.33,15.1.34,1
15.1.34,16.1.35,1
15.2.35,16.2.36,1
15.3.36,16.3.37,1
15.4.37,16.4.38,1
15.5.38,16.5.39,1
15.6.39,16.6.40,1
15.7.40,16.7.41,1
16.1.41,17.1.42,1
16.2.42,17.2.43,1
16.3.43,17.3.44,1
16.4.44,17.4.45,1
16.5.45,17.5.46,1
16.6.46,17.6.47,1
16.7.47,17.7.48,1
17.1.48,18.1.49,1
17.2.49,18.2.50,1
17.3.50,18.3.51,1
