_,1.1.1,0
1.1.1,2.1.2,1
2.1.2,3.1.3,1
3.1.3,4.1.4,1
4.1.4,5.1.5,1
4.2.5,5.2.6,1
4.3.6,5.3.7,1
5.1.7,6.1.8,1
5.2.8,6.2.9,1
5.3.9,6.3.10,1
6.1.10,7.1.11,1
6.2.11,7.2.12,1
6.3.12,7.3.13,1
6.4.13,7.4.14,1
6.5.14,7.5.15,1
7.1.15,8.1.16,1
8.1.16,9.1.17,1
9.1.17,10.1.18,1
9.2.18,10.2.19,1
9.3.19,10.3.20,1
10.1.20,11.1.21,1
10.2.21,11.2.22,1
10.3.22,11.3.23,1
10.4.23,11.4.24,1
10.5.24,11.5.25,1
10.6.25,11.6.26,1
11.1.26,12.1.27,1
12.1.27,13.1.28,1
13.1.28,14.1.29,1
14.1.29,15.1.30,1
15.1.30,16.1.31,1
16.1.31,17.1.32,1
16.2.32,17.2.33,1
16.3.33,17.3.34,1
16.4.34,17.4.35,1
16.5.35,17.5.36,1
