_,1.1.1,0
1.1.1,2.1.2,1
2.1.2,3.1.3,1
3.1.3,4.1.4,1
4.1.4,5.1.5,1
5.1.5,6.1.6,1
6.1.6,7.1.7,1
7.1.7,8.1.8,1
7.2.8,8.2.9,1
8.1.9,9.1.10,1
8.2.10,9.2.11,1
8.3.11,9.3.12,1
8.4.12,9.4.13,1
8.5.13,9.5.14,1
8.6.14,9.6.15,1
8.7.15,9.7.16,1
9.1.16,10.1.17,1
10.1.17,11.1.18,1
11.1.18,12.1.19,1
11.2.19,12.2.20,1
11.3.20,12.3.21,1
11.4.21,12.4.22,1
12.1.22,13.1.23,1
13.1.23,14.1.24,1
14.1.24,15.1.25,1
14.2.25,15.2.26,1
14.3.26,15.3.27,1
14.4.27,15.4.28,1
14.5.28,15.5.29,1
14.6.29,15.6.30,1
14.7.30,15.7.31,1
14.8.31,15.8.32,1
14.9.32,15.9.33,1
14.10.33,15.10.34,1
14.11.34,15.11.35,1
14.12.35,15.12.36,1
14.13.36,15.13.37,1
15.1.37,16.1.38,1
15.2.38,16.2.39,1
15.3.39,16.3.40,1
15.4.40,16.4.41,1
15.5.41,16.5.42,1
15.6.42,16.6.43,1
15.7.43,16.7.44,1
15.8.44,16.8.45,1
15.9.45,16.9.46,1
