_,1.1.1,0
1.1.1,2.1.2,1
2.1.2,3.1.3,1
3.1.3,4.1.4,1
4.1.4,5.1.5,1
4.2.5,5.2.6,1
4.3.6,5.3.7,1
4.4.7,5.4.8,1
4.5.8,5.5.9,1
4.6.9,5.6.10,1
4.7.10,5.7.11,1
4.8.11,5.8.12,1
4.9.12,5.9.13,1
5.1.13,6.1.14,1
6.1.14,7.1.15,1
7.1.15,8.1.16,1
8.1.16,9.1.17,1
8.2.17,9.2.18,1
8.3.18,9.3.19,1
9.1.19,10.1.20,1
10.1.20,11.1.21,1
11.1.21,12.1.22,1
12.1.22,13.1.23,1
12.2.23,13.2.24,1
12.3.24,13.3.25,1
13.1.25,14.1.26,1
13.2.26,14.2.27,1
13.3.27,14.3.28,1
14.1.28,15.1.29,1
14.2.29,15.2.30,1
14.3.30,15.3.31,1
15.1.31,16.1.32,1
16.1.32,17.1.33,1
17.1.33,18.1.34,1
17.2.34,18.2.35,1
17.3.35,18.3.36,1
17.4.36,18.4.37,1
17.5.37,18.5.38,1
17.6.38,18.6.39,1
17.7.39,18.7.40,1
17.8.40,18.8.41,1
17.9.41,18.9.42,1
17.10.42,18.10.43,1
17.11.43,18.11.44,1
18.1.44,19.1.45,1
18.2.45,19.2.46,1
18.3.46,19.3.47,1
19.1.47,20.1.48,1
19.2.48,20.2.49,1
19.3.49,20.3.50,1
19.4.50,20.4.51,1
19.5.51,20.5.52,1
19.6.52,20.6.53,1
19.7.53,20.7.54,1
19.8.54,20.8.55,1
19.9.55,20.9.56,1
19.10.56,20.10.57,1
19.11.57,20.11.58,1
20.1.58,21.1.59,1
21.1.59,22.1.60,1
22.1.60,23.1.61,1
23.1.61,24.1.62,1
23.2.62,24.2.63,1
23.3.63,24.3.64,1
24.1.64,25.1.65,1
25.1.65,26.1.66,1
25.2.66,26.2.67,1
25.3.67,26.3.68,1
25.4.68,26.4.69,1
25.5.69,26.5.70,1
25.6.70,26.6.71,1
26.1.71,27.1.72,1
27.1.72,28.1.73,1
28.1.73,29.1.74,1
29.1.74,30.1.75,1
30.1.75,31.1.76,1
31.1.76,32.1.77,1
32.1.77,33.1.78,1
33.1.78,34.1.79,1
34.1.79,35.1.80,1
