_,1.1.1,0
1.1.1,2.1.2,1
2.1.2,3.1.3,1
3.1.3,4.1.4,1
4.1.4,5.1.5,1
5.1.5,6.1.6,1
5.2.6,6.2.7,1
5.3.7,6.3.8,1
5.4.8,6.4.9,1
5.5.9,6.5.10,1
5.6.10,6.6.11,1
5.7.11,6.7.12,1
6.1.12,7.1.13,1
7.1.13,8.1.14,1
7.2.14,8.2.15,1
7.3.15,8.3.16,1
7.4.16,8.4.17,1
7.5.17,8.5.18,1
8.1.18,9.1.19,1
9.1.19,10.1.20,1
10.1.20,11.1.21,1
11.1.21,12.1.22,1
12.1.22,13.1.23,1
12.2.23,13.2.24,1
12.3.24,13.3.25,1
13.1.25,14.1.26,1
14.1.26,15.1.27,1
14.2.27,15.2.28,1
14.3.28,15.3.29,1
14.4.29,15.4.30,1
14.5.30,15.5.31,1
14.6.31,15.6.32,1
14.7.32,15.7.33,1
15.1.33,16.1.34,1
15.2.34,16.2.35,1
15.3.35,16.3.36,1
15.4.36,16.4.37,1
16.1.37,17.1.38,1
16.2.38,17.2.39,1
16.3.39,17.3.40,1
16.4.40,17.4.41,1
16.5.41,17.5.42,1
16.6.42,17.6.43,1
16.7.43,17.7.44,1
16.8.44,17.8.45,1
17.1.45,18.1.46,1
18.1.46,19.1.47,1
18.2.47,19.2.48,1
18.3.48,19.3.49,1
18.4.49,19.4.50,1
19.1.50,20.1.51,1
19.2.51,20.2.52,1
19.3.52,20.3.53,1
19.4.53,20.4.54,1
19.5.54,20.5.55,1
19.6.55,20.6.56,1
20.1.56,21.1.57,1
21.1.57,22.1.58,1
22.1.58,23.1.59,1
23.1.59,24.1.60,1
23.2.60,24.2.61,1
23.3.61,24.3.62,1
23.4.62,24.4.63,1
23.5.63,24.5.64,1
23.6.64,24.6.65,1
23.7.65,24.7.66,1
23.8.66,24.8.67,1
23.9.67,24.9.68,1
