_,1.1.1,0
1.1.1,2.1.2,1
2.1.2,3.1.3,1
3.1.3,4.1.4,1
4.1.4,5.1.5,1
4.2.5,5.2.6,1
5.1.6,6.1.7,1
5.2.7,6.2.8,1
5.3.8,6.3.9,1
6.1.9,7.1.10,1
6.2.10,7.2.11,1
7.1.11,8.1.12,1
8.1.12,9.1.13,1
8.2.13,9.2.14,1
9.1.14,10.1.15,1
10.1.15,11.1.16,1
11.1.16,12.1.17,1
12.1.17,13.1.18,1
12.2.18,13.2.19,1
13.1.19,14.1.20,1
13.2.20,14.2.21,1
13.3.21,14.3.22,1
14.1.22,15.1.23,1
14.2.23,15.2.24,1
15.1.24,16.1.25,1
15.2.25,16.2.26,1
15.3.26,16.3.27,1
16.1.27,17.1.28,1
16.2.28,17.2.29,1
