_,1.1.1,0
1.1.1,2.1.2,1
2.1.2,3.1.3,1
3.1.3,4.1.4,1
4.1.4,5.1.5,1
5.1.5,6.1.6,1
6.1.6,7.1.7,1
6.2.7,7.2.8,1
6.3.8,7.3.9,1
6.4.9,7.4.10,1
6.5.10,7.5.11,1
7.1.11,8.1.12,1
7.2.12,8.2.13,1
7.3.13,8.3.14,1
7.4.14,8.4.15,1
7.5.15,8.5.16,1
7.6.16,8.6.17,1
7.7.17,8.7.18,1
8.1.18,9.1.19,1
8.2.19,9.2.20,1
8.3.20,9.3.21,1
8.4.21,9.4.22,1
8.5.22,9.5.23,1
8.6.23,9.6.24,1
8.7.24,9.7.25,1
9.1.25,10.1.26,1
10.1.26,11.1.27,1
11.1.27,12.1.28,1
11.2.28,12.2.29,1
11.3.29,12.3.30,1
12.1.30,13.1.31,1
12.2.31,13.2.32,1
12.3.32,13.3.33,1
12.4.33,13.4.34,1
12.5.34,13.5.35,1
12.6.35,13.6.36,1
13.1.36,14.1.37,1
14.1.37,15.1.38,1
15.1.38,16.1.39,1
15.2.39,16.2.40,1
15.3.40,16.3.41,1
16.1.41,17.1.42,1
16.2.42,17.2.43,1
16.3.43,17.3.44,1
17.1.44,18.1.45,1
18.1.45,19.1.46,1
18.2.46,19.2.47,1
18.3.47,19.3.48,1
19.1.48,20.1.49,1
19.2.49,20.2.50,1
19.3.50,20.3.51,1
19.4.51,20.4.52,1
19.5.52,20.5.53,1
20.1.53,21.1.54,1
21.1.54,22.1.55,1
