_,1.1.1,0
1.1.1,2.1.2,1
2.1.2,3.1.3,1
3.1.3,4.1.4,1
4.1.4,5.1.5,1
4.2.5,5.2.6,1
4.3.6,5.3.7,1
4.4.7,5.4.8,1
4.5.8,5.5.9,1
4.6.9,5.6.10,1
4.7.10,5.7.11,1
5.1.11,6.1.12,1
6.1.12,7.1.13,1
6.2.13,7.2.14,1
6.3.14,7.3.15,1
6.4.15,7.4.16,1
6.5.16,7.5.17,1
6.6.17,7.6.18,1
6.7.18,7.7.19,1
6.8.19,7.8.20,1
7.1.20,8.1.21,1
7.2.21,8.2.22,1
7.3.22,8.3.23,1
8.1.23,9.1.24,1
9.1.24,10.1.25,1
10.1.25,11.1.26,1
10.2.26,11.2.27,1
10.3.27,11.3.28,1
10.4.28,11.4.29,1
10.5.29,11.5.30,1
10.6.30,11.6.31,1
10.7.31,11.7.32,1
10.8.32,11.8.33,1
10.9.33,11.9.34,1
10.10.34,11.10.35,1
10.11.35,11.11.36,1
10.12.36,11.12.37,1
10.13.37,11.13.38,1
10.14.38,11.14.39,1
10.15.39,11.15.40,1
10.16.40,11.16.41,1
10.17.41,11.17.42,1
11.1.42,12.1.43,1
11.2.43,12.2.44,1
11.3.44,12.3.45,1
11.4.45,12.4.46,1
11.5.46,12.5.47,1
11.6.47,12.6.48,1
11.7.48,12.7.49,1
11.8.49,12.8.50,1
11.9.50,12.9.51,1
11.10.51,12.10.52,1
11.11.52,12.11.53,1
12.1.53,13.1.54,1
13.1.54,14.1.55,1
14.1.55,15.1.56,1
15.1.56,16.1.57,1
16.1.57,17.1.58,1
17.1.58,18.1.59,1
17.2.59,18.2.60,1
17.3.60,18.3.61,1
17.4.61,18.4.62,1
18.1.62,19.1.63,1
18.2.63,19.2.64,1
18.3.64,19.3.65,1
18.4.65,19.4.66,1
18.5.66,19.5.67,1
19.1.67,20.1.68,1
19.2.68,20.2.69,1
19.3.69,20.3.70,1
19.4.70,20.4.71,1
19.5.71,20.5.72,1
19.6.72,20.6.73,1
19.7.73,20.7.74,1
19.8.74,20.8.75,1
19.9.75,20.9.76,1
19.10.76,20.10.77,1
19.11.77,20.11.78,1
19.12.78,20.12.79,1
19.13.79,20.13.80,1
19.14.80,20.14.81,1
19.15.81,20.15.82,1
19.16.82,20.16.83,1
20.1.83,21.1.84,1
20.2.84,21.2.85,1
20.3.85,21.3.86,1
20.4.86,21.4.87,1
20.5.87,21.5.88,1
21.1.88,22.1.89,1
22.1.89,23.1.90,1
23.1.90,24.1.91,1
24.1.91,25.1.92,1
24.2.92,25.2.93,1
24.3.93,25.3.94,1
24.4.94,25.4.95,1
25.1.95,26.1.96,1
26.1.96,27.1.97,1
27.1.97,28.1.98,1
28.1.98,29.1.99,1
29.1.99,30.1.100,1
30.1.100,31.1.101,1
31.1.101,32.1.102,1
32.1.102,33.1.103,1
33.1.103,34.1.104,1
34.1.104,35.1.105,1
34.2.105,35.2.106,1
34.3.106,35.3.107,1
