_,1.1.1,0
1.1.1,2.1.2,1
2.1.2,3.1.3,1
3.1.3,4.1.4,1
4.1.4,5.1.5,1
4.2.5,5.2.6,1
4.3.6,5.3.7,1
4.4.7,5.4.8,1
4.5.8,5.5.9,1
4.6.9,5.6.10,1
4.7.10,5.7.11,1
4.8.11,5.8.12,1
5.1.12,6.1.13,1
6.1.13,7.1.14,1
7.1.14,8.1.15,1
8.1.15,9.1.16,1
8.2.16,9.2.17,1
9.1.17,10.1.18,1
10.1.18,11.1.19,1
10.2.19,11.2.20,1
10.3.20,11.3.21,1
10.4.21,11.4.22,1
10.5.22,11.5.23,1
10.6.23,11.6.24,1
11.1.24,12.1.25,1
12.1.25,13.1.26,1
12.2.26,13.2.27,1
12.3.27,13.3.28,1
12.4.28,13.4.29,1
12.5.29,13.5.30,1
12.6.30,13.6.31,1
12.7.31,13.7.32,1
12.8.32,13.8.33,1
12.9.33,13.9.34,1
13.1.34,14.1.35,1
13.2.35,14.2.36,1
14.1.36,15.1.37,1
15.1.37,16.1.38,1
16.1.38,17.1.39,1
17.1.39,18.1.40,1
17.2.40,18.2.41,1
17.3.41,18.3.42,1
17.4.42,18.4.43,1
