_,1.1.1,0
1.1.1,2.1.2,1
2.1.2,3.1.3,1
3.1.3,4.1.4,1
4.1.4,5.1.5,1
4.2.5,5.2.6,1
4.3.6,5.3.7,1
5.1.7,6.1.8,1
6.1.8,7.1.9,1
7.1.9,8.1.10,1
8.1.10,9.1.11,1
9.1.11,10.1.12,1
10.1.12,11.1.13,1
11.1.13,12.1.14,1
12.1.14,13.1.15,1
13.1.15,14.1.16,1
14.1.16,15.1.17,1
15.1.17,16.1.18,1
16.1.18,17.1.19,1
17.1.19,18.1.20,1
18.1.20,19.1.21,1
19.1.21,20.1.22,1
19.2.22,20.2.23,1
19.3.23,20.3.24,1
