_,1.1.1,0
1.1.1,2.1.2,1
2.1.2,3.1.3,1
3.1.3,4.1.4,1
3.2.4,4.2.5,1
4.1.5,5.1.6,1
5.1.6,6.1.7,1
5.2.7,6.2.8,1
6.1.8,7.1.9,1
6.2.9,7.2.10,1
7.1.10,8.1.11,1
7.2.11,8.2.12,1
8.1.12,9.1.13,1
9.1.13,10.1.14,1
9.2.14,10.2.15,1
10.1.15,11.1.16,1
11.1.16,12.1.17,1
11.2.17,12.2.18,1
12.1.18,13.1.19,1
12.2.19,13.2.20,1
13.1.20,14.1.21,1
13.2.21,14.2.22,1
14.1.22,15.1.23,1
15.1.23,16.1.24,1
15.2.24,16.2.25,1
15.3.25,16.3.26,1
15.4.26,16.4.27,1
15.5.27,16.5.28,1
16.1.28,17.1.29,1
16.2.29,17.2.30,1
16.3.30,17.3.31,1
17.1.31,18.1.32,1
17.2.32,18.2.33,1
18.1.33,19.1.34,1
18.2.34,19.2.35,1
