1.1.1,1.1.1,1
2.1.2,2.1.2,1
3.1.3,3.1.3,1
4.1.4,4.1.4,1
4.2.5,4.2.5,1
5.1.6,5.1.6,1
5.2.7,5.2.7,1
5.3.8,5.3.8,1
5.4.9,5.4.9,1
5.5.10,5.5.10,1
5.6.11,5.6.11,1
5.7.12,5.7.12,1
6.1.13,6.1.13,1
6.2.14,6.2.14,0.97142863
7.1.15,7.1.15,1
7.2.16,7.2.16,1
8.1.17,8.1.17,1
8.2.18,8.2.18,1
9.1.19,9.1.19,1
10.1.20,10.1.20,1
10.2.21,10.2.21,1
11.1.22,11.1.22,1
11.2.23,11.2.23,1
11.3.24,11.3.24,1
11.4.25,11.4.25,1
11.5.26,11.5.26,1
11.6.27,11.6.27,1
11.7.28,11.7.28,1
11.8.29,11.8.29,1
11.9.30,11.9.30,1
12.1.31,12.1.31,1
12.2.32,12.2.32,1
12.3.33,12.3.33,1
13.1.34,13.1.34,1
13.2.35,13.2.35,0.97142863
14.1.36,14.1.36,1
15.1.37,15.1.37,1
15.2.38,15.2.38,1
16.1.39,16.1.39,1
16.2.40,16.2.40,1
