1.1.1,1.1.1,0.9809524
2.1.2,2.1.2,1
3.1.3,3.1.3,1
4.1.4,4.1.4,1
5.1.5,5.1.5,1
5.2.6,5.2.6,1
6.1.7,6.1.7,1
7.1.8,7.1.8,1
7.2.9,7.2.9,1
7.3.10,7.3.10,1
7.4.11,7.4.11,1
7.5.12,7.5.12,1
7.6.13,7.6.13,1
7.7.14,7.7.14,1
7.8.15,7.8.15,1
8.1.16,8.1.16,1
8.2.17,8.2.17,1
9.1.18,9.1.18,1
9.2.19,9.2.19,1
10.1.20,10.1.20,1
10.2.21,10.2.21,1
11.1.22,11.1.22,1
12.1.23,12.1.23,1
13.1.24,13.1.24,1
13.2.25,13.2.25,1
14.1.26,14.1.26,1
14.2.27,14.2.27,1
14.3.28,14.3.28,1
14.4.29,14.4.29,1
14.5.30,14.5.30,1
14.6.31,14.6.31,1
14.7.32,14.7.32,1
14.8.33,14.8.33,1
14.9.34,14.9.34,1
14.10.35,14.10.35,1
14.11.36,14.11.36,1
14.12.37,14.12.37,1
14.13.38,14.13.38,1
14.14.39,14.14.39,1
15.1.40,15.1.40,1
15.2.41,15.2.41,1
16.1.42,16.1.42,1
16.2.43,16.2.43,1
