1.1.1,1.1.1,0.9809524
2.1.2,2.1.2,1
3.1.3,3.1.3,1
4.1.4,4.1.4,1
5.1.5,5.1.5,1
5.2.6,5.2.6,1
5.3.7,5.3.7,1
5.4.8,5.4.8,1
5.5.9,5.5.9,1
5.6.10,5.6.10,1
5.7.11,5.7.11,1
5.8.12,5.8.12,1
6.1.13,6.1.13,1
7.1.14,7.1.14,1
8.1.15,8.1.15,1
9.1.16,9.1.16,1
9.2.17,9.2.17,1
10.1.18,10.1.18,1
11.1.19,11.1.19,1
11.2.20,11.2.20,1
11.3.21,11.3.21,1
11.4.22,11.4.22,1
11.5.23,11.5.23,1
11.6.24,11.6.24,1
12.1.25,12.1.25,1
13.1.26,13.1.26,1
13.2.27,13.2.27,1
13.3.28,13.3.28,1
13.4.29,13.4.29,1
13.5.30,13.5.30,1
13.6.31,13.6.31,1
13.7.32,13.7.32,1
13.8.33,13.8.33,1
13.9.34,13.9.34,1
14.1.35,14.1.35,1
14.2.36,14.2.36,1
15.1.37,15.1.37,1
16.1.38,16.1.38,1
17.1.39,17.1.39,1
18.1.40,18.1.40,1
18.2.41,18.2.41,1
18.3.42,18.3.42,1
18.4.43,18.4.43,1
