1.1.1,1.1.1,0.9809524
2.1.2,2.1.2,1
3.1.3,3.1.3,1
4.1.4,4.1.4,1
5.1.5,5.1.5,1
6.1.6,6.1.6,1
7.1.7,7.1.7,1
8.1.8,8.1.8,1
9.1.9,9.1.9,1
10.1.10,10.1.10,1
11.1.11,11.1.11,1
12.1.12,12.1.12,1
12.2.13,12.2.13,1
12.3.14,12.3.14,1
12.4.15,12.4.15,1
12.5.16,12.5.16,1
12.6.17,12.6.17,1
12.7.18,12.7.18,1
12.8.19,12.8.19,1
12.9.20,12.9.20,1
