_,5.1.7,0
_,5.2.8,0
_,5.4.10,0
_,9.1.25,0
1.1.1,1.1.1,1
2.1.2,2.1.2,1
3.1.3,3.1.3,1
4.1.4,4.1.4,1
4.2.5,4.2.5,1
4.3.6,4.3.6,0.84036905
5.1.7,_,0
5.2.8,_,0
5.3.9,5.3.9,1
5.4.10,_,0
5.5.11,_,0
5.6.12,_,0
5.7.13,_,0
6.1.14,_,0
7.1.15,_,0
7.2.16,_,0
7.3.17,_,0
7.4.18,_,0
7.5.19,_,0
8.1.20,_,0
9.1.21,6.1.11,1
10.1.22,7.1.12,1
11.1.23,8.1.13,1
11.2.24,8.2.14,1
11.3.25,8.3.15,1
11.4.26,8.4.16,1
11.5.27,8.5.17,1
11.6.28,8.6.18,1
11.7.29,8.7.19,1
11.8.30,8.8.20,1
11.9.31,8.9.21,1
11.10.32,8.10.22,1
11.11.33,8.11.23,1
11.12.34,8.12.24,1
12.1.35,10.1.26,1
13.1.36,11.1.27,1
13.2.37,11.2.28,1
13.3.38,11.3.29,1
14.1.39,12.1.30,1
14.2.40,12.2.31,1
14.3.41,12.3.32,1
14.4.42,12.4.33,1
14.5.43,12.5.34,1
15.1.44,13.1.35,1
15.2.45,13.2.36,1
15.3.46,13.3.37,1
15.4.47,13.4.38,1
15.5.48,13.5.39,0.90363646
15.6.49,13.6.40,1
15.7.50,13.7.41,1
16.1.51,14.1.42,1
17.1.52,15.1.43,1
18.1.53,16.1.44,1
18.2.54,16.2.45,1
18.3.55,16.3.46,1
18.4.56,16.4.47,1
18.5.57,16.5.48,1
18.6.58,16.6.49,1
18.7.59,16.7.50,1
18.8.60,16.8.51,1
18.9.61,16.9.52,1
18.10.62,16.10.53,1
18.11.63,16.11.54,1
18.12.64,16.12.55,1
18.13.65,16.13.56,1
18.14.66,16.14.57,1
18.15.67,16.15.58,1
18.16.68,16.16.59,1
18.17.69,16.17.60,1
19.1.70,17.1.61,1
