1.1.1,1.1.1,1
2.1.2,2.1.2,1
3.1.3,3.1.3,1
4.1.4,4.1.4,1
4.2.5,4.2.5,1
4.3.6,4.3.6,1
4.4.7,4.4.7,1
4.5.8,4.5.8,1
4.6.9,4.6.9,1
4.7.10,4.7.10,1
5.1.11,5.1.11,1
6.1.12,6.1.12,1
6.2.13,6.2.13,1
6.3.14,6.3.14,1
6.4.15,6.4.15,1
6.5.16,6.5.16,1
7.1.17,7.1.17,1
8.1.18,8.1.18,1
9.1.19,9.1.19,1
10.1.20,10.1.20,1
10.2.21,10.2.21,1
10.3.22,10.3.22,1
11.1.23,11.1.23,1
11.2.24,11.2.24,1
11.3.25,11.3.25,1
12.1.26,12.1.26,1
12.2.27,12.2.27,1
12.3.28,12.3.28,1
13.1.29,13.1.29,1
14.1.30,14.1.30,1
15.1.31,15.1.31,1
15.2.32,15.2.32,1
15.3.33,15.3.33,1
15.4.34,15.4.34,1
15.5.35,15.5.35,1
15.6.36,15.6.36,1
15.7.37,15.7.37,1
15.8.38,15.8.38,1
15.9.39,15.9.39,1
15.10.40,15.10.40,1
15.11.41,15.11.41,1
16.1.42,16.1.42,1
16.2.43,16.2.43,1
16.3.44,16.3.44,1
17.1.45,17.1.45,0.97
17.2.46,17.2.46,1
17.3.47,17.3.47,1
17.4.48,17.4.48,1
17.5.49,17.5.49,1
17.6.50,17.6.50,1
17.7.51,17.7.51,1
17.8.52,17.8.52,1
17.9.53,17.9.53,1
17.10.54,17.10.54,1
17.11.55,17.11.55,1
18.1.56,18.1.56,1
19.1.57,19.1.57,1
20.1.58,20.1.58,1
21.1.59,21.1.59,1
21.2.60,21.2.60,1
21.3.61,21.3.61,1
22.1.62,22.1.62,1
22.2.63,22.2.63,1
22.3.64,22.3.64,1
22.4.65,22.4.65,1
22.5.66,22.5.66,1
23.1.67,23.1.67,1
24.1.68,24.1.68,1
25.1.69,25.1.69,1
26.1.70,26.1.70,1
27.1.71,27.1.71,1
27.2.72,27.2.72,1
27.3.73,27.3.73,1
27.4.74,27.4.74,1
27.5.75,27.5.75,1
28.1.76,28.1.76,1
