_,2.1.2,0
1.1.1,1.1.1,0.92557305
2.1.2,3.1.3,1
3.1.3,4.1.4,1
4.1.4,5.1.5,1
4.2.5,5.2.6,1
4.3.6,5.3.7,1
4.4.7,5.4.8,1
4.5.8,5.5.9,1
4.6.9,5.6.10,0.9857143
4.7.10,5.7.11,1
4.8.11,5.8.12,1
5.1.12,6.1.13,1
6.1.13,7.1.14,1
7.1.14,8.1.15,1
8.1.15,9.1.16,1
9.1.16,10.1.17,1
10.1.17,11.1.18,1
11.1.18,12.1.19,1
12.1.19,13.1.20,1
13.1.20,14.1.21,1
14.1.21,15.1.22,1
14.2.22,15.2.23,1
14.3.23,15.3.24,1
14.4.24,15.4.25,1
14.5.25,15.5.26,1
14.6.26,15.6.27,1
14.7.27,15.7.28,1
14.8.28,15.8.29,1
15.1.29,16.1.30,1
16.1.30,17.1.31,1
17.1.31,18.1.32,1
18.1.32,19.1.33,1
19.1.33,20.1.34,1
