_,2.1.2,0
_,13.1.26,0
_,14.1.27,0
1.1.1,1.1.1,0.6459446
2.1.2,3.1.3,1
3.1.3,4.1.4,1
4.1.4,5.1.5,1
5.1.5,6.1.6,1
6.1.6,7.1.7,1
6.2.7,7.2.8,1
6.3.8,7.3.9,1
6.4.9,7.4.10,1
6.5.10,7.5.11,1
7.1.11,8.1.12,1
7.2.12,8.2.13,1
7.3.13,8.3.14,1
7.4.14,8.4.15,1
8.1.15,9.1.16,1
9.1.16,10.1.17,1
10.1.17,11.1.18,1
10.2.18,11.2.19,1
10.3.19,11.3.20,1
10.4.20,11.4.21,1
10.5.21,11.5.22,1
11.1.22,12.1.23,1
11.2.23,12.2.24,1
11.3.24,12.3.25,1
12.1.25,15.1.28,0.68250424
12.2.26,15.2.29,1
12.3.27,15.3.30,1
13.1.28,16.1.31,1
14.1.29,17.1.32,1
14.2.30,17.2.33,1
14.3.31,17.3.34,1
14.4.32,17.4.35,1
14.5.33,17.5.36,1
14.6.34,17.6.37,1
14.7.35,17.7.38,1
15.1.36,18.1.39,1
