_,1.1.1,0
_,2.1.2,0
1.1.1,_,0
2.1.2,3.1.3,1
3.1.3,4.1.4,1
4.1.4,5.1.5,1
4.2.5,5.2.6,1
4.3.6,5.3.7,1
4.4.7,5.4.8,1
5.1.8,6.1.9,1
6.1.9,7.1.10,1
6.2.10,7.2.11,1
6.3.11,7.3.12,1
6.4.12,7.4.13,1
6.5.13,7.5.14,1
6.6.14,7.6.15,1
6.7.15,7.7.16,1
6.8.16,7.8.17,1
7.1.17,8.1.18,1
8.1.18,9.1.19,1
8.2.19,9.2.20,1
8.3.20,9.3.21,1
8.4.21,9.4.22,1
9.1.22,10.1.23,1
10.1.23,11.1.24,0.9945946
11.1.24,12.1.25,1
11.2.25,12.2.26,1
11.3.26,12.3.27,1
11.4.27,12.4.28,1
12.1.28,13.1.29,1
13.1.29,14.1.30,1
13.2.30,14.2.31,1
13.3.31,14.3.32,1
13.4.32,14.4.33,1
13.5.33,14.5.34,1
13.6.34,14.6.35,1
13.7.35,14.7.36,1
13.8.36,14.8.37,1
13.9.37,14.9.38,1
13.10.38,14.10.39,1
13.11.39,14.11.40,1
13.12.40,14.12.41,1
13.13.41,14.13.42,1
13.14.42,14.14.43,1
13.15.43,14.15.44,1
13.16.44,14.16.45,1
13.17.45,14.17.46,1
13.18.46,14.18.47,1
14.1.47,15.1.48,1
