1.1.1,1.1.1,1
2.1.2,2.1.2,1
3.1.3,3.1.3,1
4.1.4,4.1.4,1
5.1.5,5.1.5,1
5.2.6,5.2.6,1
5.3.7,5.3.7,1
6.1.8,6.1.8,1
7.1.9,7.1.9,1
7.2.10,7.2.10,1
7.3.11,7.3.11,1
8.1.12,8.1.12,1
8.2.13,8.2.13,1
9.1.14,9.1.14,1
10.1.15,10.1.15,1
10.2.16,10.2.16,1
10.3.17,10.3.17,1
10.4.18,10.4.18,1
10.5.19,10.5.19,1
10.6.20,10.6.20,1
11.1.21,11.1.21,0.86536586
12.1.22,12.1.22,1
13.1.23,13.1.23,1
13.2.24,13.2.24,1
13.3.25,13.3.25,1
13.4.26,13.4.26,1
13.5.27,13.5.27,1
13.6.28,13.6.28,1
13.7.29,13.7.29,1
14.1.30,14.1.30,1
15.1.31,15.1.31,1
16.1.32,16.1.32,1
