_,4.1.8,0
_,5.1.9,0
1.1.1,1.1.1,1
1.2.2,1.2.2,1
1.3.3,1.3.3,1
1.4.4,1.4.4,1
1.5.5,1.5.5,1
2.1.6,2.1.6,1
3.1.7,3.1.7,1
4.1.8,6.1.10,1
5.1.9,7.1.11,1
6.1.10,8.1.12,1
6.2.11,8.2.13,1
7.1.12,9.1.14,1
8.1.13,10.1.15,1
8.2.14,10.2.16,1
8.3.15,10.3.17,1
8.4.16,10.4.18,1
8.5.17,10.5.19,1
9.1.18,11.1.20,1
10.1.19,12.1.21,1
10.2.20,12.2.22,1
10.3.21,12.3.23,1
11.1.22,13.1.24,1
12.1.23,14.1.25,1
12.2.24,14.2.26,1
12.3.25,14.3.27,1
13.1.26,15.1.28,1
14.1.27,16.1.29,1
15.1.28,17.1.30,1
15.2.29,17.2.31,1
16.1.30,18.1.32,1
17.1.31,19.1.33,1
17.2.32,19.2.34,1
17.3.33,19.3.35,1
17.4.34,19.4.36,1
17.5.35,19.5.37,1
17.6.36,19.6.38,1
17.7.37,19.7.39,1
17.8.38,19.8.40,1
