1.1.1,1.1.1,1
2.1.2,2.1.2,1
3.1.3,3.1.3,1
4.1.4,4.1.4,1
5.1.5,5.1.5,1
6.1.6,6.1.6,1
7.1.7,7.1.7,1
8.1.8,8.1.8,1
8.2.9,8.2.9,1
8.3.10,8.3.10,1
9.1.11,9.1.11,1
10.1.12,10.1.12,1
11.1.13,11.1.13,1
12.1.14,12.1.14,1
13.1.15,13.1.15,1
14.1.16,14.1.16,1
15.1.17,15.1.17,0.9979094
16.1.18,16.1.18,1
17.1.19,17.1.19,1
18.1.20,18.1.20,1
19.1.21,19.1.21,1
19.2.22,19.2.22,1
19.3.23,19.3.23,1
