1.1.1,1.1.1,1
2.1.2,2.1.2,1
3.1.3,3.1.3,1
4.1.4,4.1.4,1
5.1.5,5.1.5,1
6.1.6,6.1.6,1
7.1.7,7.1.7,1
7.2.8,7.2.8,1
7.3.9,7.3.9,1
7.4.10,7.4.10,1
7.5.11,7.5.11,1
8.1.12,8.1.12,1
9.1.13,9.1.13,1
9.2.14,9.2.14,0.98356164
10.1.15,10.1.15,1
11.1.16,11.1.16,1
11.2.17,11.2.17,1
11.3.18,11.3.18,1
12.1.19,12.1.19,1
13.1.20,13.1.20,1
14.1.21,14.1.21,0.9960526
14.2.22,14.2.22,1
15.1.23,15.1.23,1
16.1.24,16.1.24,1
16.2.25,16.2.25,1
16.3.26,16.3.26,1
16.4.27,16.4.27,1
16.5.28,16.5.28,1
16.6.29,16.6.29,1
16.7.30,16.7.30,1
16.8.31,16.8.31,1
