1.1.1,1.1.1,1
2.1.2,2.1.2,1
3.1.3,3.1.3,1
4.1.4,4.1.4,1
5.1.5,5.1.5,0.9512751
5.1.5,14.2.26,0.75038195
5.2.6,5.2.6,1
5.3.7,5.3.7,0.958687
6.1.8,6.1.8,1
7.1.9,7.1.9,0.93207324
8.1.10,8.1.10,1
9.1.11,9.1.11,1
10.1.12,10.1.12,1
11.1.13,11.1.13,1
12.1.14,12.1.14,1
13.1.15,13.1.15,1
13.2.16,13.2.16,0.9760001
13.3.17,13.3.17,1
13.4.18,13.4.18,1
13.5.19,13.5.19,1
13.6.20,13.6.20,1
13.7.21,13.7.21,1
13.8.22,13.8.22,0.9686687
13.9.23,13.9.23,1
13.10.24,13.10.24,1
14.1.25,14.1.25,1
14.2.26,_,0
14.3.27,14.3.27,1
14.4.28,14.4.28,1
14.5.29,14.5.29,1
14.6.30,14.6.30,1
14.7.31,14.7.31,0.9830986
14.8.32,14.8.32,1
14.9.33,14.9.33,1
15.1.34,15.1.34,1
16.1.35,16.1.35,1
16.2.36,16.2.36,1
16.3.37,16.3.37,0.7725806
17.1.38,17.1.38,1
17.2.39,17.2.39,1
17.3.40,17.3.40,1
17.4.41,17.4.41,1
17.5.42,17.5.42,1
17.6.43,17.6.43,1
17.7.44,17.7.44,1
17.8.45,17.8.45,1
17.9.46,17.9.46,1
17.10.47,17.10.47,1
17.11.48,17.11.48,1
17.12.49,17.12.49,1
18.1.50,18.1.50,1
19.1.51,19.1.51,1
