1.1.1,1.1.1,1
2.1.2,2.1.2,1
3.1.3,3.1.3,1
4.1.4,4.1.4,1
5.1.5,5.1.5,1
6.1.6,6.1.6,1
7.1.7,7.1.7,1
8.1.8,8.1.8,1
8.2.9,8.2.9,1
8.3.10,8.3.10,1
9.1.11,9.1.11,1
10.1.12,10.1.12,1
11.1.13,11.1.13,1
12.1.14,12.1.14,1
13.1.15,13.1.15,1
14.1.16,14.1.16,1
15.1.17,15.1.17,1
15.2.18,15.2.18,1
15.3.19,15.3.19,1
15.4.20,15.4.20,1
15.5.21,15.5.21,1
