1.1.1,1.1.1,1
2.1.2,2.1.2,1
3.1.3,3.1.3,1
4.1.4,4.1.4,1
5.1.5,5.1.5,1
5.2.6,5.2.6,1
6.1.7,6.1.7,1
7.1.8,7.1.8,1
7.2.9,7.2.9,1
7.3.10,7.3.10,1
8.1.11,8.1.11,1
9.1.12,9.1.12,1
10.1.13,10.1.13,1
10.2.14,10.2.14,1
10.3.15,10.3.15,1
11.1.16,11.1.16,1
11.2.17,11.2.17,1
12.1.18,12.1.18,1
12.2.19,12.2.19,1
13.1.20,13.1.20,1
13.2.21,13.2.21,1
13.3.22,13.3.22,1
14.1.23,14.1.23,1
14.2.24,14.2.24,1
