1.1.1,1.1.1,1
2.1.2,2.1.2,1
3.1.3,3.1.3,1
4.1.4,4.1.4,1
5.1.5,5.1.5,1
6.1.6,6.1.6,1
7.1.7,7.1.7,1
8.1.8,8.1.8,1
9.1.9,9.1.9,1
10.1.10,10.1.10,1
11.1.11,11.1.11,1
11.2.12,11.2.12,1
11.3.13,11.3.13,0.7725806
12.1.14,12.1.14,1
12.2.15,12.2.15,1
12.3.16,12.3.16,1
12.4.17,12.4.17,1
12.5.18,12.5.18,1
12.6.19,12.6.19,1
12.7.20,12.7.20,1
12.8.21,12.8.21,1
12.9.22,12.9.22,1
12.10.23,12.10.23,1
12.11.24,12.11.24,1
12.12.25,12.12.25,1
13.1.26,13.1.26,1
14.1.27,14.1.27,1
