_,9.1.13,0
_,10.2.15,0
1.1.1,1.1.1,1
2.1.2,2.1.2,1
3.1.3,3.1.3,1
4.1.4,4.1.4,1
5.1.5,5.1.5,1
6.1.6,6.1.6,1
7.1.7,7.1.7,1
8.1.8,8.1.8,1
8.2.9,8.2.9,1
8.3.10,8.3.10,1
8.4.11,8.4.11,1
8.5.12,8.5.12,1
9.1.13,_,0
10.1.14,10.1.14,0.90848386
11.1.15,11.1.16,1
12.1.16,12.1.17,1
12.2.17,12.2.18,1
12.3.18,12.3.19,1
13.1.19,13.1.20,1
14.1.20,14.1.21,1
15.1.21,15.1.22,1
15.2.22,15.2.23,1
16.1.23,16.1.24,1
17.1.24,17.1.25,1
17.2.25,17.2.26,1
17.3.26,17.3.27,1
17.4.27,17.4.28,1
17.5.28,17.5.29,1
17.6.29,17.6.30,1
17.7.30,17.7.31,1
17.8.31,17.8.32,1
