1.1.1,1.1.1,1
1.2.2,1.2.2,1
1.3.3,1.3.3,1
1.4.4,1.4.4,1
1.5.5,1.5.5,1
2.1.6,2.1.6,1
3.1.7,3.1.7,1
4.1.8,4.1.8,1
4.2.9,4.2.9,1
4.3.10,4.3.10,1
5.1.11,5.1.11,1
5.2.12,5.2.12,1
5.3.13,5.3.13,1
6.1.14,6.1.14,1
7.1.15,7.1.15,1
8.1.16,8.1.16,1
9.1.17,9.1.17,1
10.1.18,10.1.18,1
10.2.19,10.2.19,1
10.3.20,10.3.20,1
10.4.21,10.4.21,1
10.5.22,10.5.22,1
10.6.23,10.6.23,1
10.7.24,10.7.24,1
10.8.25,10.8.25,1
10.9.26,10.9.26,1
10.10.27,10.10.27,1
10.11.28,10.11.28,1
10.12.29,10.12.29,1
10.13.30,10.13.30,1
11.1.31,11.1.31,0.95000005
11.2.32,11.2.32,1
11.3.33,11.3.33,1
12.1.34,12.1.34,1
13.1.35,13.1.35,1
14.1.36,14.1.36,1
14.2.37,14.2.37,1
14.3.38,14.3.38,1
14.4.39,14.4.39,1
14.5.40,14.5.40,1
14.6.41,14.6.41,1
15.1.42,15.1.42,1
16.1.43,16.1.43,1
17.1.44,17.1.44,1
17.2.45,17.2.45,1
17.3.46,17.3.46,1
17.4.47,17.4.47,1
17.5.48,17.5.48,1
