1.1.1,1.1.1,1
2.1.2,2.1.2,1
3.1.3,3.1.3,1
4.1.4,4.1.4,1
5.1.5,5.1.5,1
6.1.6,6.1.6,1
6.2.7,6.2.7,1
6.3.8,6.3.8,1
6.4.9,6.4.9,1
7.1.10,7.1.10,0.95555556
8.1.11,8.1.11,1
8.2.12,8.2.12,1
9.1.13,9.1.13,1
10.1.14,10.1.14,1
11.1.15,11.1.15,1
11.2.16,11.2.16,1
11.3.17,11.3.17,1
11.4.18,11.4.18,1
11.5.19,11.5.19,1
11.6.20,11.6.20,1
12.1.21,12.1.21,1
13.1.22,13.1.22,0.928125
14.1.23,14.1.23,1
14.2.24,14.2.24,1
14.3.25,14.3.25,1
14.4.26,14.4.26,1
14.5.27,14.5.27,1
15.1.28,15.1.28,1
16.1.29,16.1.29,1
17.1.30,17.1.30,1
18.1.31,18.1.31,1
18.2.32,18.2.32,1
18.3.33,18.3.33,1
18.4.34,18.4.34,1
18.5.35,18.5.35,1
18.6.36,18.6.36,1
18.7.37,18.7.37,1
18.8.38,18.8.38,1
