1.1.1,1.1.1,0.7460788
2.1.2,2.1.2,1
3.1.3,_,0
4.1.4,_,0
5.1.5,_,0
5.2.6,5.2.6,0.56048805
5.3.7,_,0
5.4.8,_,0
6.1.9,_,0
7.1.10,_,0
7.2.11,_,0
7.3.12,_,0
7.4.13,_,0
7.5.14,_,0
7.6.15,_,0
7.7.16,_,0
7.8.17,_,0
8.1.18,_,0
9.1.19,_,0
9.2.20,_,0
9.3.21,_,0
9.4.22,_,0
10.1.23,3.1.3,1
11.1.24,4.1.4,0.4502442
12.1.25,5.1.5,1
12.2.26,5.2.6,0.757874
12.3.27,_,0
12.4.28,_,0
13.1.29,6.1.7,1
14.1.30,7.1.8,1
14.2.31,7.2.9,1
14.3.32,7.3.10,1
14.4.33,7.4.11,1
14.5.34,7.5.12,1
14.6.35,7.6.13,1
14.7.36,7.7.14,1
14.8.37,7.8.15,1
14.9.38,7.9.16,1
14.10.39,7.10.17,1
14.11.40,7.11.18,1
14.12.41,7.12.19,1
14.13.42,7.13.20,1
14.14.43,7.14.21,1
14.15.44,7.15.22,1
14.16.45,7.16.23,1
14.17.46,7.17.24,1
14.18.47,7.18.25,1
15.1.48,8.1.26,1
