1.1.1,1.1.1,1
1.2.2,1.2.2,1
1.3.3,1.3.3,1
1.4.4,1.4.4,1
1.5.5,1.5.5,1
2.1.6,2.1.6,1
3.1.7,3.1.7,1
4.1.8,4.1.8,1
4.2.9,4.2.9,1
4.3.10,4.3.10,1
4.4.11,4.4.11,1
4.5.12,4.5.12,1
4.6.13,4.6.13,1
5.1.14,5.1.14,1
6.1.15,6.1.15,1
7.1.16,7.1.16,1
7.2.17,7.2.17,1
7.3.18,7.3.18,1
8.1.19,8.1.19,1
8.2.20,8.2.20,1
8.3.21,8.3.21,1
8.4.22,8.4.22,1
8.5.23,8.5.23,1
8.6.24,8.6.24,1
8.7.25,8.7.25,1
8.8.26,8.8.26,1
8.9.27,8.9.27,1
9.1.28,9.1.28,1
9.2.29,9.2.29,1
10.1.30,10.1.30,1
10.2.31,10.2.31,1
11.1.32,11.1.32,1
12.1.33,12.1.33,1
13.1.34,13.1.34,1
13.2.35,13.2.35,1
13.3.36,13.3.36,1
13.4.37,13.4.37,1
13.5.38,13.5.38,1
14.1.39,14.1.39,1
15.1.40,15.1.40,1
15.2.41,15.2.41,1
15.3.42,15.3.42,1
15.4.43,15.4.43,1
15.5.44,15.5.44,1
15.6.45,15.6.45,1
15.7.46,15.7.46,1
15.8.47,15.8.47,1
15.9.48,15.9.48,1
16.1.49,16.1.49,1
16.2.50,16.2.50,1
17.1.51,17.1.51,1
17.2.52,17.2.52,1
18.1.53,18.1.53,1
19.1.54,19.1.54,1
19.2.55,19.2.55,1
19.3.56,19.3.56,1
19.4.57,19.4.57,1
19.5.58,19.5.58,1
19.6.59,19.6.59,1
19.7.60,19.7.60,1
19.8.61,19.8.61,1
19.9.62,19.9.62,1
20.1.63,20.1.63,1
20.2.64,20.2.64,1
21.1.65,21.1.65,1
21.2.66,21.2.66,1
22.1.67,22.1.67,1
23.1.68,23.1.68,1
