1.1.1,1.1.1,1
2.1.2,2.1.2,1
3.1.3,3.1.3,1
4.1.4,4.1.4,1
4.2.5,4.2.5,1
4.3.6,4.3.6,1
4.4.7,4.4.7,1
4.5.8,4.5.8,1
4.6.9,4.6.9,1
4.7.10,4.7.10,1
4.8.11,4.8.11,1
5.1.12,5.1.12,1
6.1.13,6.1.13,1
7.1.14,7.1.14,1
8.1.15,8.1.15,1
8.2.16,8.2.16,1
9.1.17,9.1.17,1
10.1.18,10.1.18,1
11.1.19,11.1.19,1
11.2.20,11.2.20,1
11.3.21,11.3.21,1
11.4.22,11.4.22,1
11.5.23,11.5.23,1
11.6.24,11.6.24,1
11.7.25,11.7.25,1
11.8.26,11.8.26,1
11.9.27,11.9.27,1
12.1.28,12.1.28,1
13.1.29,13.1.29,1
14.1.30,14.1.30,1
15.1.31,15.1.31,1
15.2.32,15.2.32,1
15.3.33,15.3.33,1
15.4.34,15.4.34,1
