1.1.1,1.1.1,1
2.1.2,2.1.2,1
3.1.3,3.1.3,1
4.1.4,4.1.4,1
4.2.5,4.2.5,1
4.3.6,4.3.6,1
4.4.7,4.4.7,1
4.5.8,4.5.8,1
5.1.9,5.1.9,1
6.1.10,6.1.10,1
7.1.11,7.1.11,1
8.1.12,8.1.12,1
9.1.13,9.1.13,1
10.1.14,10.1.14,1
11.1.15,11.1.15,1
12.1.16,12.1.16,1
13.1.17,13.1.17,1
14.1.18,14.1.18,1
15.1.19,15.1.19,1
15.2.20,15.2.20,1
15.3.21,15.3.21,1
15.4.22,15.4.22,1
15.5.23,15.5.23,1
16.1.24,16.1.24,1
17.1.25,17.1.25,1
17.2.26,17.2.26,1
17.3.27,17.3.27,1
18.1.28,18.1.28,1
19.1.29,19.1.29,1
19.2.30,19.2.30,1
19.3.31,19.3.31,1
19.4.32,19.4.32,1
19.5.33,19.5.33,1
19.6.34,19.6.34,1
19.7.35,19.7.35,1
19.8.36,19.8.36,1
