1.1.1,1.1.1,1
2.1.2,2.1.2,1
3.1.3,3.1.3,1
4.1.4,4.1.4,1
4.2.5,4.2.5,1
4.3.6,4.3.6,1
4.4.7,4.4.7,1
4.5.8,4.5.8,1
4.6.9,4.6.9,1
4.7.10,4.7.10,1
5.1.11,5.1.11,1
6.1.12,6.1.12,1
6.2.13,6.2.13,1
6.3.14,6.3.14,1
6.4.15,6.4.15,1
6.5.16,6.5.16,1
6.6.17,6.6.17,1
6.7.18,6.7.18,1
6.8.19,6.8.19,1
7.1.20,7.1.20,1
7.2.21,7.2.21,1
7.3.22,7.3.22,1
8.1.23,8.1.23,1
9.1.24,9.1.24,1
10.1.25,10.1.25,1
10.2.26,10.2.26,1
10.3.27,10.3.27,1
10.4.28,10.4.28,1
10.5.29,10.5.29,1
10.6.30,10.6.30,1
10.7.31,10.7.31,1
10.8.32,10.8.32,1
10.9.33,10.9.33,1
10.10.34,10.10.34,1
10.11.35,10.11.35,1
10.12.36,10.12.36,1
10.13.37,10.13.37,1
10.14.38,10.14.38,1
10.15.39,10.15.39,1
10.16.40,10.16.40,1
10.17.41,10.17.41,1
11.1.42,11.1.42,1
11.2.43,11.2.43,1
11.3.44,11.3.44,1
11.4.45,11.4.45,1
11.5.46,11.5.46,1
11.6.47,11.6.47,1
11.7.48,11.7.48,1
11.8.49,11.8.49,1
11.9.50,11.9.50,1
11.10.51,11.10.51,1
11.11.52,11.11.52,1
12.1.53,12.1.53,1
13.1.54,13.1.54,1
14.1.55,14.1.55,1
15.1.56,15.1.56,1
16.1.57,16.1.57,1
17.1.58,17.1.58,1
17.2.59,17.2.59,1
17.3.60,17.3.60,1
17.4.61,17.4.61,1
18.1.62,18.1.62,1
18.2.63,18.2.63,1
18.3.64,18.3.64,1
18.4.65,18.4.65,1
18.5.66,18.5.66,1
19.1.67,19.1.67,1
19.2.68,19.2.68,1
19.3.69,19.3.69,1
19.4.70,19.4.70,1
19.5.71,19.5.71,1
19.6.72,19.6.72,1
19.7.73,19.7.73,1
19.8.74,19.8.74,1
19.9.75,19.9.75,1
19.10.76,19.10.76,1
19.11.77,19.11.77,1
19.12.78,19.12.78,1
19.13.79,19.13.79,1
19.14.80,19.14.80,1
19.15.81,19.15.81,1
19.16.82,19.16.82,1
20.1.83,20.1.83,1
20.2.84,20.2.84,1
20.3.85,20.3.85,1
20.4.86,20.4.86,1
20.5.87,20.5.87,1
21.1.88,21.1.88,1
22.1.89,22.1.89,1
23.1.90,23.1.90,1
24.1.91,24.1.91,1
24.2.92,24.2.92,1
24.3.93,24.3.93,1
24.4.94,24.4.94,1
25.1.95,25.1.95,1
26.1.96,26.1.96,1
27.1.97,27.1.97,1
28.1.98,28.1.98,1
29.1.99,29.1.99,1
30.1.100,30.1.100,1
31.1.101,31.1.101,1
32.1.102,32.1.102,1
33.1.103,33.1.103,1
34.1.104,34.1.104,1
34.2.105,34.2.105,1
34.3.106,34.3.106,1
