_,19.2.36,0
1.1.1,1.1.1,1
1.2.2,1.2.2,1
1.3.3,1.3.3,1
1.4.4,1.4.4,1
1.5.5,1.5.5,1
2.1.6,2.1.6,1
3.1.7,3.1.7,1
4.1.8,4.1.8,1
5.1.9,5.1.9,1
6.1.10,6.1.10,1
7.1.11,7.1.11,1
8.1.12,8.1.12,1
8.2.13,8.2.13,1
9.1.14,9.1.14,1
10.1.15,10.1.15,1
10.2.16,10.2.16,1
10.3.17,10.3.17,1
10.4.18,10.4.18,1
10.5.19,10.5.19,1
10.6.20,10.6.20,1
10.7.21,10.7.21,1
11.1.22,11.1.22,1
12.1.23,12.1.23,1
12.2.24,12.2.24,1
12.3.25,12.3.25,1
13.1.26,13.1.26,1
14.1.27,14.1.27,1
14.2.28,14.2.28,1
14.3.29,14.3.29,1
15.1.30,15.1.30,1
16.1.31,16.1.31,1
17.1.32,17.1.32,1
17.2.33,17.2.33,1
18.1.34,18.1.34,1
19.1.35,19.1.35,0.682893
19.2.36,_,0
19.3.37,_,0
19.4.38,_,0
19.5.39,19.3.37,0.60359776
19.6.40,_,0
19.7.41,_,0
19.8.42,19.4.38,0.5552659
