1.1.1,1.1.1,1
2.1.2,2.1.2,1
3.1.3,3.1.3,1
4.1.4,4.1.4,1
5.1.5,5.1.5,1
6.1.6,6.1.6,1
6.2.7,6.2.7,1
6.3.8,6.3.8,1
6.4.9,6.4.9,1
6.5.10,6.5.10,1
7.1.11,7.1.11,1
7.2.12,7.2.12,1
7.3.13,7.3.13,1
7.4.14,7.4.14,1
8.1.15,8.1.15,1
9.1.16,9.1.16,1
10.1.17,10.1.17,1
10.2.18,10.2.18,1
10.3.19,10.3.19,1
10.4.20,10.4.20,1
10.5.21,10.5.21,1
11.1.22,11.1.22,1
11.2.23,11.2.23,1
11.3.24,11.3.24,1
12.1.25,12.1.25,0.9368
12.2.26,12.2.26,1
12.3.27,12.3.27,0.96077216
13.1.28,13.1.28,1
14.1.29,14.1.29,1
14.2.30,14.2.30,1
14.3.31,14.3.31,1
14.4.32,14.4.32,1
14.5.33,14.5.33,1
14.6.34,14.6.34,1
14.7.35,14.7.35,1
15.1.36,15.1.36,1
