1.1.1,1.1.1,1
2.1.2,2.1.2,1
3.1.3,3.1.3,1
4.1.4,4.1.4,1
4.2.5,4.2.5,1
4.3.6,4.3.6,1
4.4.7,4.4.7,1
4.5.8,4.5.8,1
5.1.9,5.1.9,1
6.1.10,6.1.10,1
7.1.11,7.1.11,1
8.1.12,8.1.12,1
8.2.13,8.2.13,1
8.3.14,8.3.14,1
9.1.15,9.1.15,1
10.1.16,10.1.16,1
10.2.17,10.2.17,1
10.3.18,10.3.18,1
11.1.19,11.1.19,1
11.2.20,11.2.20,1
11.3.21,11.3.21,1
11.4.22,11.4.22,1
11.5.23,11.5.23,1
11.6.24,11.6.24,1
11.7.25,11.7.25,1
11.8.26,11.8.26,1
12.1.27,12.1.27,1
12.2.28,12.2.28,1
12.3.29,12.3.29,1
13.1.30,13.1.30,1
14.1.31,14.1.31,1
14.2.32,14.2.32,1
14.3.33,14.3.33,1
14.4.34,14.4.34,1
15.1.35,15.1.35,1
16.1.36,16.1.36,1
16.2.37,16.2.37,1
16.3.38,16.3.38,1
17.1.39,17.1.39,1
18.1.40,18.1.40,1
19.1.41,19.1.41,1
19.2.42,19.2.42,1
20.1.43,20.1.43,1
21.1.44,21.1.44,1
22.1.45,22.1.45,1
23.1.46,23.1.46,1
24.1.47,24.1.47,1
24.2.48,24.2.48,1
24.3.49,24.3.49,1
24.4.50,24.4.50,1
24.5.51,24.5.51,1
24.6.52,24.6.52,1
25.1.53,25.1.53,1
25.2.54,25.2.54,1
25.3.55,25.3.55,1
25.4.56,25.4.56,1
25.5.57,25.5.57,1
25.6.58,25.6.58,1
