_,2.1.2,0
_,14.8.29,0
1.1.1,1.1.1,1
2.1.2,3.1.3,0.90124595
3.1.3,4.1.4,1
4.1.4,5.1.5,0.84179586
5.1.5,6.1.6,1
6.1.6,7.1.7,1
7.1.7,8.1.8,1
7.2.8,8.2.9,1
7.3.9,8.3.10,1
7.4.10,8.4.11,1
7.5.11,8.5.12,0.9983696
7.6.12,8.6.13,1
7.7.13,8.7.14,1
8.1.14,9.1.15,1
9.1.15,10.1.16,1
10.1.16,11.1.17,1
10.2.17,11.2.18,1
10.3.18,11.3.19,1
11.1.19,12.1.20,1
12.1.20,13.1.21,0.88778627
13.1.21,14.1.22,1
13.2.22,14.2.23,1
13.3.23,14.3.24,1
13.4.24,14.4.25,1
13.5.25,14.5.26,1
13.6.26,14.6.27,1
13.7.27,14.7.28,0.5917462
13.8.28,14.9.30,1
13.9.29,14.10.31,1
13.10.30,14.11.32,1
13.11.31,14.12.33,1
13.12.32,14.13.34,1
14.1.33,15.1.35,1
14.2.34,15.2.36,1
14.3.35,15.3.37,1
14.4.36,15.4.38,1
14.5.37,15.5.39,1
14.6.38,15.6.40,1
14.7.39,15.7.41,1
14.8.40,15.8.42,1
14.9.41,15.9.43,1
