_,7.2.13,0
_,7.3.14,0
_,16.1.46,0
_,17.1.48,0
1.1.1,1.1.1,0.98153853
2.1.2,2.1.2,1
3.1.3,3.1.3,1
4.1.4,4.1.4,1
5.1.5,5.1.5,1
6.1.6,6.1.6,1
6.2.7,6.2.7,1
6.3.8,6.3.8,1
6.4.9,6.4.9,1
6.5.10,6.5.10,1
6.6.11,6.6.11,1
7.1.12,7.1.12,0.8038372
8.1.13,8.1.15,1
9.1.14,9.1.16,1
10.1.15,10.1.17,1
10.2.16,10.2.18,1
10.3.17,10.3.19,1
11.1.18,11.1.20,1
11.2.19,11.2.21,1
11.3.20,11.3.22,1
11.4.21,11.4.23,1
11.5.22,11.5.24,0.9142858
12.1.23,12.1.25,1
12.2.24,12.2.26,1
12.3.25,12.3.27,1
12.4.26,12.4.28,1
12.5.27,12.5.29,1
12.6.28,12.6.30,1
12.7.29,12.7.31,1
13.1.30,13.1.32,1
14.1.31,14.1.33,1
15.1.32,15.1.34,0.7294898
15.2.33,15.2.35,1
15.3.34,15.3.36,1
15.4.35,15.4.37,1
15.5.36,15.5.38,0.7890133
15.6.37,15.6.39,0.8389018
15.7.38,15.7.40,1
15.8.39,15.8.41,0.8381337
15.9.40,15.9.42,1
15.10.41,15.10.43,1
15.11.42,15.11.44,1
15.12.43,15.12.45,0.55929977
15.13.44,_,0
15.14.45,_,0
15.15.46,16.2.47,1
15.16.47,_,0
15.17.48,17.2.49,1
16.1.49,18.1.50,1
