1.1.1,1.1.1,1
2.1.2,2.1.2,1
3.1.3,3.1.3,1
3.2.4,3.2.4,1
3.3.5,3.3.5,1
3.4.6,3.4.6,1
3.5.7,3.5.7,1
4.1.8,4.1.8,1
5.1.9,5.1.9,1
6.1.10,6.1.10,1
6.2.11,6.2.11,1
6.3.12,6.3.12,1
7.1.13,7.1.13,1
8.1.14,8.1.14,1
9.1.15,9.1.15,1
10.1.16,10.1.16,1
11.1.17,11.1.17,1
12.1.18,12.1.18,1
12.2.19,12.2.19,1
12.3.20,12.3.20,1
13.1.21,13.1.21,1
14.1.22,14.1.22,1
14.2.23,14.2.23,1
14.3.24,14.3.24,1
14.4.25,14.4.25,1
14.5.26,14.5.26,1
