_,1.1.1,0
1.1.1,_,0
1.2.2,_,0
1.3.3,_,0
1.4.4,_,0
1.5.5,_,0
2.1.6,2.1.2,1
3.1.7,3.1.3,1
4.1.8,4.1.4,1
5.1.9,5.1.5,1
6.1.10,6.1.6,1
6.2.11,6.2.7,1
7.1.12,7.1.8,1
8.1.13,8.1.9,1
8.2.14,8.2.10,1
8.3.15,8.3.11,1
8.4.16,8.4.12,1
8.5.17,8.5.13,1
8.6.18,8.6.14,1
8.7.19,8.7.15,1
9.1.20,9.1.16,1
10.1.21,10.1.17,1
10.2.22,10.2.18,1
10.3.23,10.3.19,1
11.1.24,11.1.20,1
12.1.25,12.1.21,1
12.2.26,12.2.22,1
12.3.27,12.3.23,1
13.1.28,13.1.24,1
14.1.29,14.1.25,1
15.1.30,15.1.26,1
15.2.31,15.2.27,1
16.1.32,16.1.28,1
17.1.33,17.1.29,1
17.2.34,17.2.30,1
17.3.35,17.3.31,1
17.4.36,17.4.32,1
17.5.37,17.5.33,1
17.6.38,17.6.34,1
17.7.39,17.7.35,1
17.8.40,17.8.36,1
