1.1.1,1.1.1,1
2.1.2,2.1.2,1
3.1.3,3.1.3,1
4.1.4,4.1.4,1
5.1.5,5.1.5,1
6.1.6,6.1.6,1
6.2.7,6.2.7,1
6.3.8,6.3.8,1
7.1.9,7.1.9,1
8.1.10,8.1.10,1
9.1.11,9.1.11,1
9.2.12,9.2.12,1
9.3.13,9.3.13,1
9.4.14,9.4.14,1
9.5.15,9.5.15,1
10.1.16,10.1.16,1
11.1.17,11.1.17,1
11.2.18,11.2.18,1
11.3.19,11.3.19,1
12.1.20,12.1.20,1
13.1.21,13.1.21,1
14.1.22,14.1.22,1
15.1.23,15.1.23,1
16.1.24,16.1.24,1
17.1.25,17.1.25,1
18.1.26,18.1.26,1
19.1.27,19.1.27,1
19.2.28,19.2.28,1
19.3.29,19.3.29,1
19.4.30,19.4.30,1
19.5.31,19.5.31,1
20.1.32,20.1.32,1
21.1.33,21.1.33,1
