1.1.1,1.1.1,1
1.2.2,1.2.2,1
1.3.3,1.3.3,1
1.4.4,1.4.4,1
1.5.5,1.5.5,1
2.1.6,2.1.6,1
3.1.7,3.1.7,1
4.1.8,4.1.8,1
5.1.9,5.1.9,1
6.1.10,6.1.10,1
7.1.11,7.1.11,1
7.2.12,7.2.12,1
7.3.13,7.3.13,1
7.4.14,7.4.14,1
7.5.15,7.5.15,0.9951613
8.1.16,8.1.16,1
8.2.17,8.2.17,1
8.3.18,8.3.18,1
9.1.19,9.1.19,1
10.1.20,10.1.20,1
10.2.21,10.2.21,1
10.3.22,10.3.22,1
10.4.23,10.4.23,1
10.5.24,10.5.24,1
10.6.25,10.6.25,1
10.7.26,10.7.26,1
10.8.27,10.8.27,1
10.9.28,10.9.28,1
10.10.29,10.10.29,1
10.11.30,10.11.30,1
10.12.31,10.12.31,1
