_,1.1.1,0
_,1.2.2,0
_,1.3.3,0
_,1.4.4,0
_,1.5.5,0
_,9.1.16,0
_,9.2.17,0
1.1.1,_,0
2.1.2,2.1.6,1
3.1.3,3.1.7,1
4.1.4,4.1.8,0.81522065
5.1.5,5.1.9,1
6.1.6,6.1.10,0.9852203
7.1.7,7.1.11,1
7.2.8,7.2.12,1
7.3.9,7.3.13,1
7.4.10,7.4.14,1
8.1.11,8.1.15,0.7904921
9.1.12,9.3.18,1
9.2.13,9.4.19,1
10.1.14,10.1.20,1
11.1.15,11.1.21,0.9099407
12.1.16,12.1.22,1
12.2.17,12.2.23,1
12.3.18,12.3.24,1
12.4.19,12.4.25,1
12.5.20,12.5.26,1
12.6.21,12.6.27,1
13.1.22,13.1.28,1
14.1.23,14.1.29,0.9937824
15.1.24,15.1.30,1
15.2.25,15.2.31,1
15.3.26,15.3.32,1
15.4.27,15.4.33,1
15.5.28,15.5.34,1
16.1.29,16.1.35,1
17.1.30,17.1.36,1
18.1.31,18.1.37,0.9944445
19.1.32,19.1.38,1
19.2.33,19.2.39,1
19.3.34,19.3.40,1
19.4.35,19.4.41,1
19.5.36,19.5.42,1
19.6.37,19.6.43,1
19.7.38,19.7.44,1
19.8.39,19.8.45,1
