1.1.1,1.1.1,1
2.1.2,2.1.2,1
3.1.3,3.1.3,1
4.1.4,4.1.4,1
4.2.5,4.2.5,0.97818184
4.2.5,9.2.14,0.70074475
4.3.6,4.3.6,1
5.1.7,5.1.7,1
5.2.8,5.2.8,1
6.1.9,6.1.9,1
6.2.10,6.2.10,1
7.1.11,7.1.11,1
8.1.12,8.1.12,1
9.1.13,9.1.13,1
9.2.14,9.2.14,0.9785714
9.3.15,9.3.15,1
10.1.16,10.1.16,1
10.2.17,10.2.17,1
11.1.18,11.1.18,1
11.2.19,11.2.19,1
12.1.20,12.1.20,1
13.1.21,13.1.21,1
13.2.22,13.2.22,1
13.3.23,13.3.23,1
13.4.24,13.4.24,1
13.5.25,13.5.25,1
14.1.26,14.1.26,1
14.2.27,14.2.27,0.9789474
14.2.27,9.2.14,0.6167378
14.3.28,14.3.28,1
15.1.29,15.1.29,1
15.2.30,15.2.30,1
16.1.31,16.1.31,1
16.2.32,16.2.32,1
