_,5.1.5,0
_,6.1.11,0
1.1.1,1.1.1,1
2.1.2,2.1.2,1
3.1.3,3.1.3,1
4.1.4,4.1.4,1
4.2.5,5.2.6,1
4.3.6,_,0
5.1.7,5.3.7,1
5.2.8,5.4.8,1
5.3.9,5.5.9,1
5.4.10,5.6.10,1
6.1.11,_,0
7.1.12,_,0
8.1.13,_,0
8.2.14,_,0
8.3.15,_,0
8.4.16,_,0
8.5.17,_,0
8.6.18,_,0
8.7.19,_,0
8.8.20,_,0
8.9.21,_,0
8.10.22,_,0
8.11.23,_,0
8.12.24,_,0
9.1.25,7.1.12,1
10.1.26,8.1.13,1
11.1.27,9.1.14,1
11.2.28,9.2.15,1
11.3.29,9.3.16,1
12.1.30,10.1.17,1
12.2.31,10.2.18,1
12.3.32,10.3.19,1
12.4.33,10.4.20,1
12.5.34,10.5.21,1
13.1.35,11.1.22,1
13.2.36,11.2.23,1
13.3.37,11.3.24,1
13.4.38,11.4.25,1
13.5.39,11.5.26,1
13.6.40,11.6.27,1
13.7.41,11.7.28,1
14.1.42,12.1.29,1
15.1.43,13.1.30,1
16.1.44,14.1.31,1
16.2.45,14.2.32,1
16.3.46,14.3.33,1
16.4.47,14.4.34,1
16.5.48,14.5.35,1
16.6.49,14.6.36,1
16.7.50,14.7.37,1
16.8.51,14.8.38,1
16.9.52,14.9.39,1
16.10.53,14.10.40,1
16.11.54,14.11.41,1
16.12.55,14.12.42,1
16.13.56,14.13.43,1
16.14.57,14.14.44,1
16.15.58,14.15.45,1
16.16.59,14.16.46,1
16.17.60,14.17.47,1
17.1.61,15.1.48,1
