_,7.8.19,0
_,14.15.44,0
1.1.1,1.1.1,1
1.2.2,1.2.2,1
1.3.3,1.3.3,1
1.4.4,1.4.4,1
1.5.5,1.5.5,1
2.1.6,2.1.6,1
3.1.7,3.1.7,1
4.1.8,4.1.8,1
5.1.9,5.1.9,1
5.2.10,5.2.10,1
6.1.11,6.1.11,1
6.2.12,_,0
6.3.13,_,0
6.4.14,7.1.12,0.9415033
6.5.15,7.2.13,1
6.6.16,7.3.14,1
6.7.17,7.4.15,1
6.8.18,7.5.16,1
6.9.19,7.6.17,1
6.10.20,7.7.18,1
6.11.21,_,0
7.1.22,8.1.20,1
7.2.23,8.2.21,1
8.1.24,9.1.22,1
8.2.25,9.2.23,1
9.1.26,10.1.24,1
9.2.27,10.2.25,1
10.1.28,11.1.26,1
11.1.29,12.1.27,1
12.1.30,13.1.28,1
12.2.31,13.2.29,1
13.1.32,14.1.30,1
13.2.33,14.2.31,1
13.3.34,14.3.32,1
13.4.35,14.4.33,1
13.5.36,14.5.34,1
13.6.37,14.6.35,1
13.7.38,14.7.36,1
13.8.39,_,0
13.9.40,14.8.37,0.8651718
13.10.41,14.9.38,1
13.11.42,14.10.39,1
13.12.43,14.11.40,1
13.13.44,14.12.41,1
13.14.45,14.13.42,1
13.15.46,14.14.43,1
13.16.47,_,0
14.1.48,15.1.45,1
14.2.49,15.2.46,1
15.1.50,16.1.47,1
15.2.51,16.2.48,1
