1.1.1,1.1.1,1
1.2.2,1.2.2,1
1.3.3,1.3.3,1
1.4.4,1.4.4,1
1.5.5,1.5.5,1
2.1.6,2.1.6,1
3.1.7,3.1.7,1
4.1.8,4.1.8,1
5.1.9,5.1.9,1
6.1.10,6.1.10,1
7.1.11,7.1.11,1
7.2.12,8.1.12,1
8.1.13,9.1.13,1
9.1.14,10.1.14,1
10.1.15,11.1.15,1
10.2.16,11.2.16,1
10.3.17,11.3.17,1
10.4.18,11.4.18,1
10.5.19,11.5.19,1
10.6.20,11.6.20,1
10.7.21,11.7.21,1
11.1.22,12.1.22,1
12.1.23,13.1.23,1
13.1.24,14.1.24,1
14.1.25,15.1.25,1
14.2.26,15.2.26,1
14.3.27,15.3.27,1
14.4.28,15.4.28,1
14.5.29,15.5.29,1
