_,18.2.33,0
_,18.4.35,0
1.1.1,1.1.1,1
1.2.2,1.2.2,1
1.3.3,1.3.3,1
1.4.4,1.4.4,1
1.5.5,1.5.5,1
2.1.6,2.1.6,1
3.1.7,3.1.7,1
4.1.8,4.1.8,0.98444444
5.1.9,5.1.9,1
6.1.10,6.1.10,0.94933236
6.2.11,6.2.11,1
6.3.12,6.3.12,0.9156015
6.4.13,_,0
6.5.14,6.4.13,0.97097945
6.6.15,_,0
6.7.16,6.5.14,0.95882624
7.1.17,7.1.15,0.95822847
8.1.18,8.1.16,1
9.1.19,9.1.17,1
10.1.20,10.1.18,1
11.1.21,11.1.19,0.974936
11.2.22,11.2.20,1
11.3.23,11.3.21,1
12.1.24,12.1.22,1
13.1.25,13.1.23,1
14.1.26,14.1.24,1
15.1.27,15.1.25,1
16.1.28,16.1.26,1
16.2.29,16.2.27,1
17.1.30,17.1.28,1
17.2.31,17.2.29,1
17.3.32,17.3.30,1
17.4.33,17.4.31,1
18.1.34,18.1.32,0.98357975
18.2.35,_,0
18.3.36,18.3.34,0.95837224
18.4.37,_,0
18.5.38,18.5.36,1
19.1.39,19.1.37,1
19.2.40,19.2.38,1
19.3.41,19.3.39,1
19.4.42,19.4.40,1
19.5.43,19.5.41,0.96699893
19.6.44,19.6.42,1
19.7.45,19.7.43,1
19.8.46,19.8.44,1
19.9.47,19.9.45,0.95277774
19.10.48,19.10.46,1
19.11.49,19.11.47,0.94932127
19.12.50,19.12.48,1
19.13.51,19.13.49,1
19.14.52,19.14.50,1
19.15.53,19.15.51,1
19.16.54,19.16.52,0.951282
19.17.55,19.17.53,0.96389866
19.18.56,19.18.54,1
19.19.57,19.19.55,1
19.20.58,19.20.56,1
19.21.59,19.21.57,1
19.22.60,19.22.58,1
19.23.61,19.23.59,1
19.24.62,19.24.60,0.988889
19.25.63,19.25.61,1
19.26.64,19.26.62,1
19.27.65,19.27.63,1
19.28.66,19.28.64,1
19.29.67,19.29.65,0.982353
19.30.68,19.30.66,1
19.31.69,19.31.67,1
19.32.70,19.32.68,1
19.33.71,19.33.69,1
19.34.72,19.34.70,1
19.35.73,19.35.71,1
19.36.74,19.36.72,1
19.37.75,19.37.73,1
19.38.76,19.38.74,1
19.39.77,19.39.75,1
19.40.78,19.40.76,1
19.41.79,19.41.77,1
19.42.80,19.42.78,1
19.43.81,19.43.79,1
19.44.82,19.44.80,1
19.45.83,19.45.81,1
19.46.84,19.46.82,1
19.47.85,19.47.83,1
19.48.86,19.48.84,0.9640311
19.49.87,19.49.85,0.97077215
19.50.88,19.50.86,1
19.51.89,19.51.87,1
19.52.90,19.52.88,1
19.53.91,19.53.89,1
19.54.92,19.54.90,1
19.55.93,19.55.91,1
19.56.94,19.56.92,1
19.57.95,19.57.93,1
19.58.96,19.58.94,1
19.59.97,19.59.95,1
19.60.98,19.60.96,1
19.61.99,19.61.97,1
19.62.100,19.62.98,1
19.63.101,19.63.99,1
19.64.102,19.64.100,1
19.65.103,19.65.101,1
19.66.104,19.66.102,1
19.67.105,19.67.103,1
19.68.106,19.68.104,1
19.69.107,19.69.105,1
19.70.108,19.70.106,1
19.71.109,19.71.107,1
19.72.110,19.72.108,1
19.73.111,19.73.109,1
19.74.112,19.74.110,1
19.75.113,19.75.111,1
19.76.114,19.76.112,1
19.77.115,19.77.113,1
19.78.116,19.78.114,1
19.79.117,19.79.115,1
19.80.118,19.80.116,1
19.81.119,19.81.117,1
19.82.120,19.82.118,1
19.83.121,19.83.119,1
19.84.122,19.84.120,1
19.85.123,19.85.121,1
19.86.124,19.86.122,1
19.87.125,19.87.123,1
19.88.126,19.88.124,1
19.89.127,19.89.125,1
19.90.128,19.90.126,1
19.91.129,19.91.127,1
19.92.130,19.92.128,1
19.93.131,19.93.129,1
19.94.132,19.94.130,1
19.95.133,19.95.131,1
19.96.134,19.96.132,1
19.97.135,19.97.133,1
19.98.136,19.98.134,1
19.99.137,19.99.135,1
19.100.138,19.100.136,1
19.101.139,19.101.137,1
19.102.140,19.102.138,1
19.103.141,19.103.139,1
19.104.142,19.104.140,1
19.105.143,19.105.141,1
19.106.144,19.106.142,1
19.107.145,19.107.143,1
19.108.146,19.108.144,1
19.109.147,19.109.145,1
19.110.148,19.110.146,1
19.111.149,19.111.147,1
19.112.150,19.112.148,1
19.113.151,19.113.149,1
19.114.152,19.114.150,1
19.115.153,19.115.151,1
19.116.154,19.116.152,1
19.117.155,19.117.153,1
19.118.156,19.118.154,1
19.119.157,19.119.155,1
19.120.158,19.120.156,1
19.121.159,19.121.157,1
19.122.160,19.122.158,1
19.123.161,19.123.159,1
19.124.162,19.124.160,1
19.125.163,19.125.161,1
19.126.164,19.126.162,1
19.127.165,19.127.163,1
19.128.166,19.128.164,1
19.129.167,19.129.165,1
19.130.168,19.130.166,1
19.131.169,19.131.167,1
19.132.170,19.132.168,1
19.133.171,19.133.169,1
20.1.172,20.1.170,1
20.2.173,20.2.171,1
21.1.174,21.1.172,1
21.2.175,21.2.173,1
21.3.176,21.3.174,1
21.4.177,21.4.175,1
21.5.178,21.5.176,1
21.6.179,21.6.177,1
21.7.180,21.7.178,1
21.8.181,21.8.179,1
21.9.182,21.9.180,1
21.10.183,21.10.181,1
22.1.184,22.1.182,0.9930233
23.1.185,23.1.183,1
23.2.186,23.2.184,1
23.3.187,23.3.185,1
23.4.188,23.4.186,1
23.5.189,23.5.187,1
23.6.190,23.6.188,1
23.7.191,23.7.189,1
23.8.192,23.8.190,1
23.9.193,23.9.191,1
23.10.194,23.10.192,1
23.11.195,23.11.193,1
23.12.196,23.12.194,1
23.13.197,23.13.195,1
23.14.198,23.14.196,1
24.1.199,24.1.197,0.99491525
24.2.200,24.2.198,1
24.3.201,24.3.199,1
24.4.202,24.4.200,1
25.1.203,25.1.201,1
25.2.204,25.2.202,1
26.1.205,26.1.203,1
27.1.206,27.1.204,0.99005544
27.2.207,27.2.205,1
27.3.208,27.3.206,1
28.1.209,28.1.207,1
29.1.210,29.1.208,0.9869276
29.2.211,29.2.209,1
29.3.212,29.3.210,1
29.4.213,29.4.211,1
29.5.214,29.5.212,0.98597586
29.6.215,29.6.213,1
29.7.216,29.7.214,0.98746943
29.8.217,29.8.215,1
29.9.218,29.9.216,1
29.10.219,29.10.217,1
30.1.220,30.1.218,1
30.2.221,30.2.219,1
30.3.222,30.3.220,1
30.4.223,30.4.221,1
30.5.224,30.5.222,0.9971963
