1.1.1,1.1.1,1
2.1.2,2.1.2,1
3.1.3,3.1.3,1
4.1.4,4.1.4,1
5.1.5,5.1.5,0.96000004
6.1.6,6.1.6,1
6.2.7,6.2.7,1
6.3.8,6.3.8,1
6.4.9,6.4.9,1
6.5.10,6.5.10,1
7.1.11,7.1.11,1
8.1.12,8.1.12,1
9.1.13,9.1.13,1
9.2.14,9.2.14,1
10.1.15,10.1.15,1
11.1.16,11.1.16,1
11.2.17,11.2.17,1
11.3.18,11.3.18,1
12.1.19,12.1.19,1
13.1.20,13.1.20,1
14.1.21,14.1.21,1
15.1.22,15.1.22,1
15.2.23,15.2.23,1
15.3.24,15.3.24,1
16.1.25,16.1.25,1
16.2.26,16.2.26,1
16.3.27,16.3.27,1
16.4.28,16.4.28,1
16.5.29,16.5.29,1
16.6.30,16.6.30,1
17.1.31,17.1.31,1
18.1.32,18.1.32,1
18.2.33,18.2.33,1
19.1.34,19.1.34,1
