_,1.1.1,0
1.1.1,_,0
1.2.2,_,0
1.3.3,_,0
1.4.4,_,0
1.5.5,_,0
2.1.6,2.1.2,1
3.1.7,3.1.3,1
4.1.8,4.1.4,1
5.1.9,5.1.5,1
6.1.10,6.1.6,1
7.1.11,7.1.7,1
7.2.12,7.2.8,1
8.1.13,8.1.9,1
9.1.14,9.1.10,1
9.2.15,9.2.11,1
10.1.16,10.1.12,1
11.1.17,11.1.13,1
11.2.18,11.2.14,1
12.1.19,12.1.15,1
13.1.20,13.1.16,1
13.2.21,13.2.17,1
13.3.22,13.3.18,1
13.4.23,13.4.19,1
13.5.24,13.5.20,1
13.6.25,13.6.21,1
13.7.26,13.7.22,1
14.1.27,14.1.23,1
15.1.28,15.1.24,1
