_,20.1.44,0
1.1.1,1.1.1,1
1.2.2,1.2.2,1
1.3.3,1.3.3,1
1.4.4,1.4.4,1
1.5.5,1.5.5,1
2.1.6,2.1.6,1
3.1.7,3.1.7,1
4.1.8,4.1.8,1
5.1.9,5.1.9,1
6.1.10,6.1.10,1
7.1.11,7.1.11,1
7.2.12,7.2.12,1
7.3.13,7.3.13,1
7.4.14,7.4.14,1
8.1.15,8.1.15,1
9.1.16,9.1.16,1
9.2.17,9.2.17,1
9.3.18,9.3.18,1
9.4.19,9.4.19,1
10.1.20,10.1.20,1
11.1.21,11.1.21,1
12.1.22,12.1.22,1
12.2.23,12.2.23,1
12.3.24,12.3.24,1
12.4.25,12.4.25,1
12.5.26,12.5.26,1
12.6.27,12.6.27,1
13.1.28,13.1.28,1
14.1.29,14.1.29,1
15.1.30,15.1.30,1
15.2.31,15.2.31,1
15.3.32,15.3.32,1
15.4.33,15.4.33,1
15.5.34,15.5.34,1
16.1.35,16.1.35,1
17.1.36,17.1.36,1
18.1.37,18.1.37,1
19.1.38,19.1.38,1
19.2.39,19.2.39,1
19.3.40,19.3.40,1
19.4.41,19.4.41,1
19.5.42,19.5.42,1
19.6.43,19.6.43,1
19.7.44,21.1.45,1
19.8.45,21.2.46,1
