1.1.1,1.1.1,0.9836956
2.1.2,2.1.2,1
3.1.3,3.1.3,1
4.1.4,4.1.4,1
5.1.5,5.1.5,1
6.1.6,6.1.6,1
7.1.7,7.1.7,1
7.2.8,7.2.8,1
8.1.9,8.1.9,1
9.1.10,9.1.10,1
9.2.11,9.2.11,1
9.3.12,9.3.12,1
9.4.13,9.4.13,1
9.5.14,9.5.14,1
10.1.15,10.1.15,1
11.1.16,11.1.16,1
12.1.17,12.1.17,1
13.1.18,13.1.18,1
14.1.19,14.1.19,1
15.1.20,15.1.20,1
16.1.21,16.1.21,1
17.1.22,17.1.22,1
17.2.23,17.2.23,1
17.3.24,17.3.24,1
17.4.25,17.4.25,1
17.5.26,17.5.26,1
17.6.27,17.6.27,1
17.7.28,17.7.28,1
17.8.29,17.8.29,1
17.9.30,17.9.30,1
