1.1.1,1.1.1,0.9836956
2.1.2,2.1.2,1
3.1.3,3.1.3,1
4.1.4,4.1.4,1
5.1.5,5.1.5,1
6.1.6,6.1.6,1
7.1.7,7.1.7,1
8.1.8,8.1.8,1
9.1.9,9.1.9,1
10.1.10,10.1.10,1
10.2.11,10.2.11,1
10.3.12,10.3.12,1
10.4.13,10.4.13,1
10.5.14,10.5.14,1
10.6.15,10.6.15,1
10.7.16,10.7.16,1
10.8.17,10.8.17,1
10.9.18,10.9.18,1
11.1.19,11.1.19,1
12.1.20,12.1.20,1
13.1.21,13.1.21,1
14.1.22,14.1.22,1
15.1.23,15.1.23,1
16.1.24,16.1.24,1
17.1.25,17.1.25,1
18.1.26,18.1.26,1
19.1.27,19.1.27,1
19.2.28,19.2.28,1
19.3.29,19.3.29,1
20.1.30,20.1.30,1
21.1.31,21.1.31,1
22.1.32,22.1.32,1
22.2.33,22.2.33,1
22.3.34,22.3.34,1
23.1.35,23.1.35,1
24.1.36,24.1.36,1
25.1.37,25.1.37,1
