_,7.1.7,0
_,13.1.19,0
1.1.1,1.1.1,1
2.1.2,2.1.2,1
3.1.3,3.1.3,1
4.1.4,4.1.4,0.818342
5.1.5,5.1.5,0.796898
6.1.6,6.1.6,0.7534977
7.1.7,8.1.8,1
8.1.8,9.1.9,1
9.1.9,10.1.10,1
9.2.10,10.2.11,1
9.3.11,10.3.12,1
9.4.12,10.4.13,1
9.5.13,10.5.14,1
10.1.14,11.1.15,1
11.1.15,12.1.16,1
11.2.16,12.2.17,1
11.3.17,12.3.18,1
12.1.18,14.1.20,1
13.1.19,15.1.21,1
13.2.20,15.2.22,1
13.3.21,15.3.23,1
13.4.22,15.4.24,1
13.5.23,15.5.25,1
14.1.24,16.1.26,1
15.1.25,17.1.27,1
16.1.26,18.1.28,1
16.2.27,18.2.29,1
16.3.28,18.3.30,1
16.4.29,18.4.31,1
16.5.30,18.5.32,1
17.1.31,19.1.33,1
18.1.32,20.1.34,1
18.2.33,20.2.35,1
18.3.34,20.3.36,1
18.4.35,20.4.37,1
18.5.36,20.5.38,1
18.6.37,20.6.39,1
18.7.38,20.7.40,1
18.8.39,20.8.41,1
18.9.40,20.9.42,1
