1.1.1,1.1.1,1
2.1.2,2.1.2,1
3.1.3,3.1.3,1
4.1.4,4.1.4,1
5.1.5,5.1.5,1
6.1.6,6.1.6,1
7.1.7,_,0
8.1.8,7.1.7,1
8.2.9,7.2.8,1
9.1.10,8.1.9,1
10.1.11,9.1.10,1
10.2.12,9.2.11,1
10.3.13,9.3.12,1
10.4.14,9.4.13,1
10.5.15,9.5.14,1
11.1.16,10.1.15,1
12.1.17,11.1.16,1
13.1.18,12.1.17,1
14.1.19,13.1.18,1
15.1.20,14.1.19,1
16.1.21,15.1.20,1
17.1.22,16.1.21,1
18.1.23,17.1.22,1
18.2.24,17.2.23,1
18.3.25,17.3.24,0.99405944
18.4.26,17.4.25,1
18.5.27,17.5.26,1
18.6.28,17.6.27,1
18.7.29,17.7.28,1
18.8.30,17.8.29,1
18.9.31,17.9.30,1
