1.1.1,1.1.1,1
2.1.2,2.1.2,1
3.1.3,3.1.3,1
4.1.4,4.1.4,1
5.1.5,5.1.5,1
5.2.6,5.2.6,0.9872341
6.1.7,6.1.7,1
6.2.8,6.2.8,1
6.3.9,6.3.9,1
6.4.10,6.4.10,1
6.5.11,6.5.11,1
6.6.12,6.6.12,1
6.7.13,6.7.13,1
6.8.14,6.8.14,1
7.1.15,7.1.15,1
7.2.16,7.2.16,1
8.1.17,8.1.17,1
8.2.18,8.2.18,1
8.3.19,8.3.19,1
8.4.20,8.4.20,1
8.5.21,8.5.21,1
9.1.22,9.1.22,1
10.1.23,10.1.23,1
10.2.24,10.2.24,1
10.3.25,10.3.25,1
10.4.26,10.4.26,1
11.1.27,11.1.27,1
12.1.28,12.1.28,1
12.2.29,12.2.29,1
13.1.30,13.1.30,1
14.1.31,14.1.31,1
14.2.32,14.2.32,1
14.3.33,14.3.33,1
14.4.34,14.4.34,1
14.5.35,14.5.35,1
14.6.36,14.6.36,1
14.7.37,14.7.37,1
14.8.38,14.8.38,1
14.9.39,14.9.39,1
14.10.40,14.10.40,1
