1.1.1,1.1.1,1
2.1.2,2.1.2,1
3.1.3,3.1.3,0.96419835
4.1.4,4.1.4,1
5.1.5,5.1.5,1
6.1.6,6.1.6,0.97451043
6.2.7,6.2.7,0.96857905
7.1.8,7.1.8,1
8.1.9,8.1.9,1
9.1.10,9.1.10,1
10.1.11,10.1.11,0.98368037
11.1.12,11.1.12,1
11.2.13,11.2.13,1
11.3.14,11.3.14,1
11.4.15,11.4.15,1
11.5.16,11.5.16,1
11.6.17,11.6.17,0.9400008
11.7.18,11.7.18,0.9320847
12.1.19,12.1.19,1
13.1.20,13.1.20,1
14.1.21,14.1.21,0.9184161
14.2.22,14.2.22,1
14.3.23,14.3.23,1
14.4.24,14.4.24,1
14.5.25,14.5.25,1
15.1.26,15.1.26,1
16.1.27,16.1.27,0.90004516
17.1.28,17.1.28,1
18.1.29,18.1.29,1
18.2.30,18.2.30,1
18.3.31,18.3.31,0.8653053
18.4.32,18.4.32,1
18.5.33,18.5.33,1
