_,1.1.1,0
_,1.2.2,0
_,1.3.3,0
_,1.4.4,0
_,1.5.5,0
1.1.1,_,0
2.1.2,2.1.6,1
3.1.3,3.1.7,1
4.1.4,4.1.8,1
5.1.5,5.1.9,1
6.1.6,6.1.10,1
7.1.7,7.1.11,1
8.1.8,8.1.12,1
8.2.9,8.2.13,1
8.3.10,8.3.14,1
9.1.11,9.1.15,1
9.2.12,9.2.16,1
9.3.13,9.3.17,1
9.4.14,9.4.18,1
9.5.15,9.5.19,1
10.1.16,10.1.20,1
10.2.17,10.2.21,1
10.3.18,10.3.22,1
11.1.19,11.1.23,1
12.1.20,12.1.24,1
13.1.21,13.1.25,1
13.2.22,13.2.26,1
13.3.23,13.3.27,1
13.4.24,13.4.28,1
13.5.25,13.5.29,1
13.6.26,13.6.30,1
14.1.27,14.1.31,1
15.1.28,15.1.32,1
15.2.29,15.2.33,1
15.3.30,15.3.34,1
15.4.31,15.4.35,1
15.5.32,15.5.36,1
15.6.33,15.6.37,1
15.7.34,15.7.38,1
16.1.35,16.1.39,1
17.1.36,17.1.40,1
