_,1.1.1,0
_,1.2.2,0
_,1.3.3,0
_,1.4.4,0
_,1.5.5,0
1.1.1,_,0
2.1.2,2.1.6,1
3.1.3,3.1.7,1
4.1.4,4.1.8,1
5.1.5,5.1.9,1
6.1.6,6.1.10,1
7.1.7,7.1.11,1
8.1.8,8.1.12,1
9.1.9,9.1.13,1
10.1.10,10.1.14,1
11.1.11,11.1.15,1
12.1.12,12.1.16,1
12.2.13,12.2.17,1
13.1.14,13.1.18,1
13.2.15,13.2.19,1
13.3.16,13.3.20,1
13.4.17,13.4.21,1
14.1.18,14.1.22,1
15.1.19,15.1.23,1
16.1.20,16.1.24,1
17.1.21,17.1.25,1
18.1.22,18.1.26,1
19.1.23,19.1.27,1
20.1.24,20.1.28,1
