_,1.1.1,0
_,1.2.2,0
_,1.3.3,0
_,1.4.4,0
_,1.5.5,0
1.1.1,_,0
2.1.2,2.1.6,1
3.1.3,3.1.7,1
4.1.4,4.1.8,1
5.1.5,5.1.9,1
5.2.6,5.2.10,1
5.3.7,5.3.11,1
6.1.8,6.1.12,1
6.2.9,6.2.13,1
6.3.10,6.3.14,1
7.1.11,7.1.15,1
7.2.12,7.2.16,1
7.3.13,7.3.17,1
7.4.14,7.4.18,1
7.5.15,7.5.19,1
8.1.16,8.1.20,1
9.1.17,9.1.21,1
10.1.18,10.1.22,1
11.1.19,11.1.23,1
12.1.20,12.1.24,1
12.2.21,12.2.25,1
12.3.22,12.3.26,1
12.4.23,12.4.27,1
12.5.24,12.5.28,1
12.6.25,12.6.29,1
12.7.26,12.7.30,1
13.1.27,13.1.31,1
14.1.28,14.1.32,1
15.1.29,15.1.33,1
16.1.30,16.1.34,1
17.1.31,17.1.35,1
18.1.32,18.1.36,1
18.2.33,18.2.37,1
18.3.34,18.3.38,1
18.4.35,18.4.39,1
18.5.36,18.5.40,1
