_,1.1.1,0
_,1.2.2,0
_,1.3.3,0
_,1.4.4,0
_,1.5.5,0
1.1.1,_,0
2.1.2,2.1.6,1
3.1.3,3.1.7,1
4.1.4,4.1.8,1
4.2.5,4.2.9,1
5.1.6,5.1.10,1
6.1.7,6.1.11,1
7.1.8,7.1.12,1
8.1.9,8.1.13,1
9.1.10,9.1.14,1
9.2.11,9.2.15,1
9.3.12,9.3.16,1
10.1.13,10.1.17,1
10.2.14,10.2.18,1
11.1.15,11.1.19,1
12.1.16,12.1.20,1
13.1.17,13.1.21,1
13.2.18,13.2.22,1
14.1.19,14.1.23,1
14.2.20,14.2.24,1
14.3.21,14.3.25,1
14.4.22,14.4.26,1
14.5.23,14.5.27,1
14.6.24,14.6.28,1
14.7.25,14.7.29,1
14.8.26,14.8.30,1
14.9.27,14.9.31,1
14.10.28,14.10.32,1
14.11.29,14.11.33,1
15.1.30,15.1.34,1
16.1.31,16.1.35,1
17.1.32,17.1.36,1
18.1.33,18.1.37,1
18.2.34,18.2.38,1
18.3.35,18.3.39,1
19.1.36,19.1.40,1
19.2.37,19.2.41,1
