_,1.1.1,0
_,1.2.2,0
_,1.3.3,0
_,1.4.4,0
_,1.5.5,0
1.1.1,_,0
2.1.2,2.1.6,1
3.1.3,3.1.7,1
4.1.4,4.1.8,1
5.1.5,5.1.9,1
5.2.6,5.2.10,1
6.1.7,6.1.11,1
6.2.8,6.2.12,1
6.3.9,6.3.13,1
7.1.10,7.1.14,1
8.1.11,8.1.15,1
8.2.12,8.2.16,1
9.1.13,9.1.17,1
10.1.14,10.1.18,1
10.2.15,10.2.19,1
10.3.16,10.3.20,1
10.4.17,10.4.21,1
10.5.18,10.5.22,1
11.1.19,11.1.23,1
12.1.20,12.1.24,1
12.2.21,12.2.25,1
13.1.22,13.1.26,1
14.1.23,14.1.27,1
15.1.24,15.1.28,1
16.1.25,16.1.29,1
16.2.26,16.2.30,1
16.3.27,16.3.31,1
17.1.28,17.1.32,1
17.2.29,17.2.33,1
17.3.30,17.3.34,1
17.4.31,17.4.35,1
17.5.32,17.5.36,1
18.1.33,18.1.37,1
18.2.34,18.2.38,1
18.3.35,18.3.39,1
