1.1.1,1.1.1,1
1.2.2,1.2.2,1
1.3.3,1.3.3,1
1.4.4,1.4.4,1
1.5.5,1.5.5,1
2.1.6,2.1.6,1
3.1.7,3.1.7,1
4.1.8,4.1.8,1
5.1.9,5.1.9,1
6.1.10,6.1.10,1
6.2.11,6.2.11,1
6.3.12,6.3.12,1
7.1.13,7.1.13,1
8.1.14,8.1.14,1
8.2.15,8.2.15,1
8.3.16,8.3.16,1
9.1.17,9.1.17,1
9.2.18,9.2.18,1
9.3.19,9.3.19,1
9.4.20,9.4.20,1
9.5.21,9.5.21,1
9.6.22,9.6.22,1
9.7.23,9.7.23,1
10.1.24,10.1.24,1
11.1.25,11.1.25,1
12.1.26,12.1.26,1
12.2.27,12.2.27,1
12.3.28,12.3.28,1
12.4.29,12.4.29,1
12.5.30,12.5.30,1
12.6.31,12.6.31,1
12.7.32,12.7.32,1
13.1.33,13.1.33,1
14.1.34,14.1.34,1
14.2.35,14.2.35,1
14.3.36,14.3.36,1
14.4.37,14.4.37,1
14.5.38,14.5.38,1
