_,1.1.1,0
_,1.2.2,0
_,1.3.3,0
_,1.4.4,0
_,1.5.5,0
1.1.1,_,0
2.1.2,2.1.6,1
3.1.3,3.1.7,1
4.1.4,4.1.8,1
5.1.5,5.1.9,1
6.1.6,6.1.10,1
7.1.7,7.1.11,1
7.2.8,7.2.12,1
7.3.9,7.3.13,1
7.4.10,7.4.14,1
7.5.11,7.5.15,1
8.1.12,8.1.16,1
9.1.13,9.1.17,1
10.1.14,10.1.18,1
10.2.15,10.2.19,1
11.1.16,11.1.20,1
12.1.17,12.1.21,1
12.2.18,12.2.22,1
12.3.19,12.3.23,1
13.1.20,13.1.24,1
14.1.21,14.1.25,1
14.2.22,14.2.26,1
14.3.23,14.3.27,1
14.4.24,14.4.28,1
14.5.25,14.5.29,1
14.6.26,14.6.30,1
14.7.27,14.7.31,1
15.1.28,15.1.32,1
16.1.29,16.1.33,1
16.2.30,16.2.34,1
16.3.31,16.3.35,1
17.1.32,17.1.36,1
17.2.33,17.2.37,1
17.3.34,17.3.38,1
17.4.35,17.4.39,1
17.5.36,17.5.40,1
17.6.37,17.6.41,1
18.1.38,18.1.42,1
19.1.39,19.1.43,1
19.2.40,19.2.44,1
19.3.41,19.3.45,1
19.4.42,19.4.46,1
20.1.43,20.1.47,1
21.1.44,21.1.48,1
22.1.45,22.1.49,1
