_,1.1.1,0
_,1.2.2,0
_,1.3.3,0
_,1.4.4,0
_,1.5.5,0
1.1.1,_,0
2.1.2,2.1.6,1
3.1.3,3.1.7,1
4.1.4,4.1.8,1
4.2.5,4.2.9,1
5.1.6,5.1.10,1
5.2.7,5.2.11,1
5.3.8,5.3.12,1
5.4.9,5.4.13,1
5.5.10,5.5.14,1
5.6.11,5.6.15,1
5.7.12,5.7.16,1
5.8.13,5.8.17,1
5.9.14,5.9.18,1
6.1.15,6.1.19,1
6.2.16,6.2.20,1
7.1.17,7.1.21,1
7.2.18,7.2.22,1
8.1.19,8.1.23,1
8.2.20,8.2.24,1
9.1.21,9.1.25,1
10.1.22,10.1.26,1
10.2.23,10.2.27,1
10.3.24,10.3.28,1
11.1.25,11.1.29,1
11.2.26,11.2.30,1
11.3.27,11.3.31,1
11.4.28,11.4.32,1
11.5.29,11.5.33,1
11.6.30,11.6.34,1
11.7.31,11.7.35,1
11.8.32,11.8.36,1
11.9.33,11.9.37,1
12.1.34,12.1.38,1
12.2.35,12.2.39,1
12.3.36,12.3.40,1
13.1.37,13.1.41,1
13.2.38,13.2.42,1
14.1.39,14.1.43,1
15.1.40,15.1.44,1
15.2.41,15.2.45,1
15.3.42,15.3.46,1
16.1.43,16.1.47,1
16.2.44,16.2.48,1
