_,1.1.1,0
_,1.2.2,0
_,1.3.3,0
_,1.4.4,0
_,1.5.5,0
1.1.1,_,0
2.1.2,2.1.6,1
3.1.3,3.1.7,1
4.1.4,4.1.8,1
4.2.5,4.2.9,1
4.3.6,4.3.10,1
5.1.7,5.1.11,1
5.2.8,5.2.12,1
5.3.9,5.3.13,1
6.1.10,6.1.14,1
7.1.11,7.1.15,1
8.1.12,8.1.16,1
9.1.13,9.1.17,1
10.1.14,10.1.18,1
10.2.15,10.2.19,1
10.3.16,10.3.20,1
10.4.17,10.4.21,1
10.5.18,10.5.22,1
10.6.19,10.6.23,1
10.7.20,10.7.24,1
10.8.21,10.8.25,1
10.9.22,10.9.26,1
10.10.23,10.10.27,1
10.11.24,10.11.28,1
10.12.25,10.12.29,1
10.13.26,10.13.30,1
11.1.27,11.1.31,1
11.2.28,11.2.32,1
11.3.29,11.3.33,1
12.1.30,12.1.34,1
13.1.31,13.1.35,1
14.1.32,14.1.36,1
14.2.33,14.2.37,1
14.3.34,14.3.38,1
14.4.35,14.4.39,1
14.5.36,14.5.40,1
14.6.37,14.6.41,1
15.1.38,15.1.42,1
16.1.39,16.1.43,1
17.1.40,17.1.44,1
17.2.41,17.2.45,1
17.3.42,17.3.46,1
17.4.43,17.4.47,1
17.5.44,17.5.48,1
