_,1.1.1,0
_,1.2.2,0
_,1.3.3,0
_,1.4.4,0
_,1.5.5,0
1.1.1,_,0
2.1.2,2.1.6,1
3.1.3,3.1.7,1
4.1.4,4.1.8,1
5.1.5,5.1.9,1
5.2.6,5.2.10,1
6.1.7,6.1.11,1
7.1.8,7.1.12,1
7.2.9,7.2.13,1
7.3.10,7.3.14,1
7.4.11,7.4.15,1
7.5.12,7.5.16,1
7.6.13,7.6.17,1
7.7.14,7.7.18,1
7.8.15,7.8.19,1
8.1.16,8.1.20,1
8.2.17,8.2.21,1
9.1.18,9.1.22,1
9.2.19,9.2.23,1
10.1.20,10.1.24,1
10.2.21,10.2.25,1
11.1.22,11.1.26,1
12.1.23,12.1.27,1
13.1.24,13.1.28,1
13.2.25,13.2.29,1
14.1.26,14.1.30,1
14.2.27,14.2.31,1
14.3.28,14.3.32,1
14.4.29,14.4.33,1
14.5.30,14.5.34,1
14.6.31,14.6.35,1
14.7.32,14.7.36,1
14.8.33,14.8.37,1
14.9.34,14.9.38,1
14.10.35,14.10.39,1
14.11.36,14.11.40,1
14.12.37,14.12.41,1
14.13.38,14.13.42,1
14.14.39,14.14.43,1
15.1.40,15.1.44,1
15.2.41,15.2.45,1
16.1.42,16.1.46,1
16.2.43,16.2.47,1
