_,19.1.71,0
_,19.2.72,0
_,19.3.73,0
_,19.4.74,0
_,19.5.75,0
_,19.6.76,0
_,19.7.77,0
_,19.8.78,0
_,19.9.79,0
_,19.10.80,0
_,19.11.81,0
_,19.12.82,0
_,19.13.83,0
_,19.14.84,0
_,19.15.85,0
_,19.16.86,0
_,19.17.87,0
_,19.18.88,0
1.1.1,1.1.1,1
1.2.2,1.2.2,1
1.3.3,1.3.3,1
1.4.4,1.4.4,1
1.5.5,1.5.5,1
2.1.6,2.1.6,1
3.1.7,3.1.7,1
4.1.8,4.1.8,1
5.1.9,5.1.9,1
6.1.10,6.1.10,1
6.2.11,6.2.11,1
6.3.12,6.3.12,1
6.4.13,6.4.13,1
6.5.14,6.5.14,1
6.6.15,6.6.15,1
6.7.16,6.7.16,1
6.8.17,6.8.17,1
6.9.18,6.9.18,1
6.10.19,6.10.19,1
6.11.20,6.11.20,1
7.1.21,7.1.21,1
8.1.22,8.1.22,1
8.2.23,8.2.23,1
8.3.24,8.3.24,1
8.4.25,8.4.25,1
9.1.26,9.1.26,1
10.1.27,10.1.27,1
10.2.28,10.2.28,1
10.3.29,10.3.29,1
10.4.30,10.4.30,1
11.1.31,11.1.31,1
12.1.32,12.1.32,1
13.1.33,13.1.33,1
14.1.34,14.1.34,1
14.2.35,14.2.35,1
14.3.36,14.3.36,1
14.4.37,14.4.37,1
14.5.38,14.5.38,1
15.1.39,15.1.39,1
15.2.40,15.2.40,1
15.3.41,15.3.41,1
15.4.42,15.4.42,1
15.5.43,15.5.43,1
15.6.44,15.6.44,1
15.7.45,15.7.45,1
15.8.46,15.8.46,1
15.9.47,15.9.47,1
15.10.48,15.10.48,1
15.11.49,15.11.49,1
15.12.50,15.12.50,1
15.13.51,15.13.51,1
15.14.52,15.14.52,1
15.15.53,15.15.53,1
15.16.54,15.16.54,1
15.17.55,15.17.55,1
15.18.56,15.18.56,1
15.19.57,15.19.57,1
15.20.58,15.20.58,1
15.21.59,15.21.59,1
16.1.60,16.1.60,1
16.2.61,16.2.61,1
16.3.62,16.3.62,1
16.4.63,16.4.63,1
16.5.64,16.5.64,1
16.6.65,16.6.65,1
16.7.66,16.7.66,1
17.1.67,17.1.67,1
18.1.68,18.1.68,1
18.2.69,18.2.69,1
18.3.70,18.3.70,1
