1.1.1,1.1.1,1
2.1.2,2.1.2,1
3.1.3,3.1.3,1
4.1.4,4.1.4,1
5.1.5,5.1.5,1
6.1.6,6.1.6,1
6.2.7,6.2.7,1
6.3.8,6.3.8,1
7.1.9,7.1.9,1
7.2.10,7.2.10,1
7.3.11,7.3.11,1
7.4.12,7.4.12,1
7.5.13,7.5.13,1
8.1.14,8.1.14,1
9.1.15,9.1.15,1
9.2.16,9.2.16,1
9.3.17,9.3.17,1
9.4.18,9.4.18,1
9.5.19,9.5.19,1
9.6.20,9.6.20,1
9.7.21,9.7.21,1
10.1.22,10.1.22,1
11.1.23,11.1.23,1
12.1.24,12.1.24,1
12.2.25,12.2.25,1
12.3.26,12.3.26,1
12.4.27,12.4.27,1
12.5.28,12.5.28,1
12.6.29,12.6.29,1
13.1.30,13.1.30,1
14.1.31,14.1.31,1
15.1.32,15.1.32,1
15.2.33,15.2.33,1
15.3.34,15.3.34,1
15.4.35,15.4.35,1
15.5.36,15.5.36,1
15.6.37,15.6.37,1
15.7.38,15.7.38,1
15.8.39,15.8.39,1
15.9.40,15.9.40,1
15.10.41,15.10.41,1
15.11.42,15.11.42,1
15.12.43,15.12.43,1
15.13.44,15.13.44,1
15.14.45,15.14.45,1
16.1.46,16.1.46,1
17.1.47,17.1.47,1
18.1.48,18.1.48,1
19.1.49,19.1.49,1
19.2.50,19.2.50,1
19.3.51,19.3.51,1
19.4.52,19.4.52,1
19.5.53,19.5.53,1
19.6.54,19.6.54,1
19.7.55,19.7.55,1
19.8.56,19.8.56,1
19.9.57,19.9.57,1
19.10.58,19.10.58,1
19.11.59,19.11.59,1
19.12.60,19.12.60,1
19.13.61,19.13.61,1
20.1.62,20.1.62,1
21.1.63,21.1.63,1
22.1.64,22.1.64,1
22.2.65,22.2.65,1
22.3.66,22.3.66,1
22.4.67,22.4.67,1
22.5.68,22.5.68,1
22.6.69,22.6.69,1
22.7.70,22.7.70,1
