_,18.3.41,0
_,18.4.42,0
_,18.5.43,0
_,19.1.44,0
_,19.2.45,0
_,20.1.48,0
1.1.1,1.1.1,1
1.2.2,1.2.2,1
1.3.3,1.3.3,1
1.4.4,1.4.4,1
1.5.5,1.5.5,1
2.1.6,2.1.6,0.97
3.1.7,3.1.7,1
4.1.8,4.1.8,1
5.1.9,5.1.9,1
6.1.10,6.1.10,1
7.1.11,7.1.11,0.9625
8.1.12,8.1.12,1
9.1.13,9.1.13,1
9.2.14,9.2.14,1
9.3.15,9.3.15,1
9.4.16,9.4.16,1
10.1.17,10.1.17,0.99215686
10.2.18,10.2.18,1
10.3.19,10.3.19,1
10.4.20,10.4.20,1
10.5.21,10.5.21,1
10.6.22,10.6.22,1
10.7.23,10.7.23,1
10.8.24,10.8.24,1
10.9.25,10.9.25,1
11.1.26,11.1.26,0.94807696
12.1.27,12.1.27,1
12.2.28,12.2.28,1
12.3.29,12.3.29,1
13.1.30,13.1.30,1
14.1.31,14.1.31,0.9456579
15.1.32,15.1.32,0.98450255
16.1.33,16.1.33,1
17.1.34,17.1.34,1
17.2.35,17.2.35,1
17.3.36,17.3.36,1
17.4.37,17.4.37,1
17.5.38,17.5.38,0.89134586
17.6.39,18.2.40,1
17.7.40,18.1.39,0.5642196
18.1.41,19.3.46,1
18.2.42,19.4.47,1
