_,17.1.20,0
_,20.1.23,0
_,21.1.24,0
_,22.1.25,0
1.1.1,1.1.1,1
2.1.2,2.1.2,1
3.1.3,3.1.3,1
4.1.4,4.1.4,1
5.1.5,5.1.5,1
6.1.6,6.1.6,1
7.1.7,7.1.7,1
8.1.8,8.1.8,1
9.1.9,9.1.9,1
10.1.10,10.1.10,1
10.2.11,10.2.11,1
11.1.12,11.1.12,1
12.1.13,12.1.13,1
12.2.14,12.2.14,1
13.1.15,13.1.15,1
14.1.16,14.1.16,1
15.1.17,15.1.17,1
15.2.18,15.2.18,1
16.1.19,16.1.19,1
17.1.20,18.1.21,1
18.1.21,19.1.22,1
