1.1.1,1.1.1,1
2.1.2,2.1.2,1
3.1.3,3.1.3,1
4.1.4,4.1.4,1
4.2.5,4.2.5,1
4.3.6,4.3.6,1
4.4.7,4.4.7,1
4.5.8,4.5.8,1
5.1.9,5.1.9,1
6.1.10,6.1.10,1
7.1.11,7.1.11,1
8.1.12,8.1.12,1
9.1.13,9.1.13,1
10.1.14,10.1.14,1
11.1.15,11.1.15,1
12.1.16,12.1.16,1
12.2.17,12.2.17,1
12.3.18,12.3.18,1
12.4.19,12.4.19,1
12.5.20,12.5.20,1
12.6.21,12.6.21,1
13.1.22,13.1.22,1
13.2.23,13.2.23,1
13.3.24,13.3.24,1
14.1.25,14.1.25,1
14.2.26,14.2.26,1
14.3.27,14.3.27,1
