1.1.1,1.1.1,1
2.1.2,2.1.2,1
3.1.3,3.1.3,1
4.1.4,4.1.4,1
5.1.5,5.1.5,1
5.2.6,5.2.6,1
5.3.7,5.3.7,1
5.4.8,5.4.8,1
5.5.9,5.5.9,1
5.6.10,5.6.10,1
5.7.11,5.7.11,1
5.8.12,5.8.12,1
6.1.13,6.1.13,1
6.2.14,6.2.14,1
7.1.15,_,0
7.2.16,_,0
8.1.17,7.1.15,1
8.2.18,7.2.16,1
8.3.19,7.3.17,1
9.1.20,8.1.18,1
10.1.21,9.1.19,1
10.2.22,9.2.20,1
10.3.23,9.3.21,1
10.4.24,9.4.22,1
10.5.25,9.5.23,1
10.6.26,9.6.24,1
10.7.27,9.7.25,1
10.8.28,9.8.26,1
10.9.29,9.9.27,1
10.10.30,9.10.28,1
10.11.31,9.11.29,1
10.12.32,9.12.30,1
10.13.33,9.13.31,1
10.14.34,9.14.32,1
11.1.35,10.1.33,1
11.2.36,10.2.34,1
12.1.37,_,0
12.2.38,_,0
13.1.39,11.1.35,1
13.2.40,11.2.36,1
13.3.41,11.3.37,1
