_,15.1.20,0
_,15.2.21,0
_,15.5.24,0
_,15.6.25,0
_,15.7.26,0
_,15.8.27,0
_,15.9.28,0
1.1.1,1.1.1,1
2.1.2,2.1.2,1
3.1.3,3.1.3,1
4.1.4,4.1.4,1
5.1.5,5.1.5,1
6.1.6,6.1.6,1
6.2.7,6.2.7,1
6.3.8,6.3.8,1
7.1.9,7.1.9,1
8.1.10,8.1.10,1
9.1.11,9.1.11,1
10.1.12,10.1.12,1
10.2.13,10.2.13,1
10.3.14,10.3.14,1
11.1.15,11.1.15,1
12.1.16,12.1.16,1
12.2.17,12.2.17,1
13.1.18,13.1.18,1
14.1.19,14.1.19,1
15.1.20,15.3.22,1
15.2.21,15.4.23,1
15.3.22,15.10.29,0.6596499
16.1.23,16.1.30,1
17.1.24,17.1.31,1
17.2.25,17.2.32,1
17.3.26,17.3.33,1
17.4.27,17.4.34,1
18.1.28,18.1.35,1
18.2.29,18.2.36,1
19.1.30,19.1.37,1
20.1.31,20.1.38,1
21.1.32,21.1.39,1
