1.1.1,1.1.1,1
2.1.2,2.1.2,0.9228421
3.1.3,3.1.3,0.9257758
4.1.4,4.1.4,0.91987514
5.1.5,5.1.5,1
6.1.6,6.1.6,1
6.2.7,6.2.7,1
6.3.8,6.3.8,1
7.1.9,7.1.9,1
8.1.10,8.1.10,1
9.1.11,9.1.11,1
10.1.12,10.1.12,1
11.1.13,11.1.13,0.8909091
12.1.14,12.1.14,1
13.1.15,13.1.15,1
14.1.16,14.1.16,1
14.2.17,14.2.17,1
14.3.18,14.3.18,1
14.4.19,14.4.19,1
14.5.20,14.5.20,1
14.6.21,14.6.21,1
14.7.22,14.7.22,1
14.8.23,14.8.23,1
14.9.24,14.9.24,1
14.10.25,14.10.25,1
15.1.26,15.1.26,1
15.2.27,15.2.27,1
15.3.28,15.3.28,1
15.4.29,15.4.29,1
15.5.30,15.5.30,1
15.6.31,15.6.31,1
15.7.32,15.7.32,1
15.8.33,15.8.33,1
15.9.34,15.9.34,1
16.1.35,16.1.35,0.9
17.1.36,17.1.36,1
17.2.37,17.2.37,1
17.3.38,17.3.38,1
18.1.39,18.1.39,1
18.2.40,18.2.40,1
18.3.41,18.3.41,1
18.4.42,18.4.42,1
18.5.43,18.5.43,1
18.6.44,18.6.44,1
18.7.45,18.7.45,1
18.8.46,18.8.46,1
18.9.47,18.9.47,1
18.10.48,18.10.48,1
18.11.49,18.11.49,1
18.12.50,18.12.50,1
19.1.51,19.1.51,0.8956522
20.1.52,20.1.52,1
