_,5.2.11,0
1.1.1,1.1.1,1
1.2.2,1.2.2,1
1.3.3,1.3.3,1
1.4.4,1.4.4,1
1.5.5,1.5.5,1
2.1.6,2.1.6,1
3.1.7,3.1.7,1
4.1.8,4.1.8,1
4.2.9,4.2.9,1
5.1.10,5.1.10,1
5.2.11,5.3.12,1
5.3.12,5.4.13,1
6.1.13,6.1.14,1
6.2.14,6.2.15,1
7.1.15,7.1.16,1
8.1.16,8.1.17,1
8.2.17,8.2.18,1
9.1.18,9.1.19,1
9.2.19,9.2.20,1
10.1.20,10.1.21,1
11.1.21,11.1.22,1
12.1.22,12.1.23,1
12.2.23,12.2.24,1
13.1.24,13.1.25,1
13.2.25,13.2.26,1
13.3.26,13.3.27,1
13.4.27,13.4.28,1
13.5.28,13.5.29,1
13.6.29,13.6.30,1
13.7.30,13.7.31,1
14.1.31,14.1.32,1
14.2.32,14.2.33,1
15.1.33,15.1.34,1
16.1.34,16.1.35,1
16.2.35,16.2.36,1
17.1.36,17.1.37,1
17.2.37,17.2.38,1
