_,6.2.18,0
_,7.2.26,0
_,15.2.42,0
1.1.1,1.1.1,1
1.2.2,1.2.2,1
1.3.3,1.3.3,1
1.4.4,1.4.4,1
1.5.5,1.5.5,1
2.1.6,2.1.6,1
3.1.7,3.1.7,1
4.1.8,4.1.8,1
4.2.9,4.2.9,1
5.1.10,5.1.10,1
5.2.11,5.2.11,1
5.3.12,5.3.12,1
5.4.13,5.4.13,1
5.5.14,5.5.14,1
5.6.15,5.6.15,1
5.7.16,5.7.16,1
6.1.17,6.1.17,1
6.2.18,6.3.19,1
6.3.19,6.4.20,1
6.4.20,6.5.21,1
6.5.21,6.6.22,1
6.6.22,6.7.23,1
6.7.23,6.8.24,1
7.1.24,7.1.25,1
7.2.25,7.3.27,1
7.3.26,7.4.28,1
8.1.27,8.1.29,1
8.2.28,8.2.30,1
9.1.29,9.1.31,1
10.1.30,10.1.32,1
10.2.31,10.2.33,1
10.3.32,10.3.34,1
11.1.33,11.1.35,1
11.2.34,11.2.36,1
12.1.35,12.1.37,1
13.1.36,13.1.38,1
13.2.37,13.2.39,1
14.1.38,14.1.40,1
15.1.39,15.1.41,1
15.2.40,15.3.43,1
15.3.41,15.4.44,1
15.4.42,15.5.45,1
15.5.43,15.6.46,1
15.6.44,15.7.47,1
15.7.45,15.8.48,1
15.8.46,15.9.49,1
15.9.47,15.10.50,1
16.1.48,16.1.51,1
16.2.49,16.2.52,1
16.3.50,16.3.53,1
16.4.51,16.4.54,1
16.5.52,16.5.55,1
17.1.53,17.1.56,1
18.1.54,18.1.57,1
18.2.55,18.2.58,1
18.3.56,18.3.59,1
19.1.57,19.1.60,1
