_,5.2.11,0
1.1.1,1.1.1,1
1.2.2,1.2.2,1
1.3.3,1.3.3,1
1.4.4,1.4.4,1
1.5.5,1.5.5,1
2.1.6,2.1.6,1
3.1.7,3.1.7,1
4.1.8,4.1.8,1
4.2.9,4.2.9,1
5.1.10,5.1.10,1
5.2.11,5.3.12,1
5.3.12,5.4.13,1
5.4.13,5.5.14,1
5.5.14,5.6.15,1
5.6.15,5.7.16,1
5.7.16,5.8.17,0.858427
6.1.17,6.1.18,1
6.2.18,6.2.19,1
6.3.19,6.3.20,1
6.4.20,6.4.21,1
6.5.21,6.5.22,1
6.6.22,6.6.23,1
7.1.23,7.1.24,1
7.2.24,7.2.25,1
7.3.25,7.3.26,1
8.1.26,8.1.27,1
9.1.27,9.1.28,1
9.2.28,9.2.29,1
10.1.29,10.1.30,1
10.2.30,10.2.31,1
10.3.31,10.3.32,1
11.1.32,11.1.33,1
12.1.33,12.1.34,1
13.1.34,13.1.35,1
13.2.35,13.2.36,1
14.1.36,14.1.37,1
14.2.37,14.2.38,1
14.3.38,14.3.39,1
15.1.39,15.1.40,1
15.2.40,15.2.41,1
15.3.41,15.3.42,1
15.4.42,15.4.43,1
15.5.43,15.5.44,1
15.6.44,15.6.45,1
15.7.45,15.7.46,1
15.8.46,15.8.47,1
15.9.47,15.9.48,1
15.10.48,15.10.49,1
16.1.49,16.1.50,1
16.2.50,16.2.51,1
16.3.51,16.3.52,1
16.4.52,16.4.53,1
16.5.53,16.5.54,1
17.1.54,17.1.55,1
17.2.55,17.2.56,1
17.3.56,17.3.57,1
18.1.57,18.1.58,1
