_,7.2.17,0
1.1.1,1.1.1,1
1.2.2,1.2.2,1
1.3.3,1.3.3,1
1.4.4,1.4.4,1
1.5.5,1.5.5,1
2.1.6,2.1.6,1
3.1.7,3.1.7,1
4.1.8,4.1.8,1
5.1.9,5.1.9,1
6.1.10,6.1.10,1
6.2.11,6.2.11,1
6.3.12,6.3.12,1
6.4.13,6.4.13,1
6.5.14,6.5.14,1
6.6.15,6.6.15,1
7.1.16,7.1.16,1
7.2.17,7.3.18,1
7.3.18,7.4.19,1
8.1.19,8.1.20,1
9.1.20,9.1.21,1
10.1.21,10.1.22,1
10.2.22,10.2.23,1
10.3.23,10.3.24,1
11.1.24,11.1.25,1
11.2.25,11.2.26,1
11.3.26,11.3.27,1
11.4.27,11.4.28,1
11.5.28,11.5.29,1
11.6.29,11.6.30,1
12.1.30,12.1.31,1
13.1.31,13.1.32,1
14.1.32,14.1.33,1
14.2.33,14.2.34,1
14.3.34,14.3.35,1
14.4.35,14.4.36,1
14.5.36,14.5.37,1
14.6.37,14.6.38,1
14.7.38,14.7.39,1
14.8.39,14.8.40,1
14.9.40,14.9.41,1
14.10.41,14.10.42,1
14.11.42,14.11.43,1
14.12.43,14.12.44,1
14.13.44,14.13.45,1
14.14.45,14.14.46,1
14.15.46,14.15.47,1
15.1.47,15.1.48,1
15.2.48,15.2.49,1
15.3.49,15.3.50,1
16.1.50,16.1.51,1
16.2.51,16.2.52,1
17.1.52,17.1.53,1
