_,18.1.37,0
1.1.1,1.1.1,1
2.1.2,2.1.2,1
3.1.3,3.1.3,1
4.1.4,4.1.4,1
5.1.5,5.1.5,1
5.2.6,5.2.6,1
5.3.7,5.3.7,1
5.4.8,5.4.8,1
5.5.9,5.5.9,1
6.1.10,6.1.10,1
6.2.11,6.2.11,1
6.3.12,6.3.12,1
6.4.13,6.4.13,1
6.5.14,6.5.14,1
7.1.15,7.1.15,1
8.1.16,8.1.16,1
9.1.17,9.1.17,1
10.1.18,10.1.18,1
10.2.19,10.2.19,1
10.3.20,10.3.20,1
10.4.21,10.4.21,1
10.5.22,10.5.22,1
10.6.23,10.6.23,1
10.7.24,10.7.24,1
11.1.25,11.1.25,1
12.1.26,12.1.26,1
12.2.27,12.2.27,1
12.3.28,12.3.28,1
13.1.29,13.1.29,1
14.1.30,14.1.30,1
15.1.31,15.1.31,1
16.1.32,16.1.32,1
16.2.33,16.2.33,1
16.3.34,16.3.34,1
16.4.35,16.4.35,1
17.1.36,17.1.36,1
