_,19.1.56,0
_,21.3.60,0
_,21.6.63,0
1.1.1,1.1.1,1
2.1.2,2.1.2,1
3.1.3,3.1.3,1
4.1.4,4.1.4,1
5.1.5,5.1.5,1
5.2.6,5.2.6,1
5.3.7,5.3.7,1
6.1.8,6.1.8,1
6.2.9,6.2.9,1
6.3.10,6.3.10,1
6.4.11,6.4.11,1
7.1.12,7.1.12,1
8.1.13,8.1.13,1
8.2.14,8.2.14,1
8.3.15,8.3.15,1
8.4.16,8.4.16,1
8.5.17,8.5.17,1
8.6.18,8.6.18,1
9.1.19,9.1.19,1
10.1.20,10.1.20,1
11.1.21,11.1.21,1
11.2.22,11.2.22,1
11.3.23,11.3.23,1
11.4.24,11.4.24,1
12.1.25,12.1.25,1
13.1.26,13.1.26,1
14.1.27,14.1.27,1
14.2.28,14.2.28,1
14.3.29,14.3.29,1
14.4.30,14.4.30,1
14.5.31,14.5.31,1
14.6.32,14.6.32,1
14.7.33,14.7.33,1
14.8.34,14.8.34,1
14.9.35,14.9.35,1
14.10.36,14.10.36,1
14.11.37,14.11.37,1
14.12.38,14.12.38,1
14.13.39,14.13.39,1
14.14.40,14.14.40,1
15.1.41,15.1.41,1
16.1.42,16.1.42,1
17.1.43,17.1.43,1
18.1.44,18.1.44,1
18.2.45,18.2.45,1
18.3.46,18.3.46,1
18.4.47,18.4.47,1
18.5.48,18.5.48,1
18.6.49,18.6.49,1
18.7.50,18.7.50,1
18.8.51,18.8.51,1
18.9.52,18.9.52,1
18.10.53,18.10.53,1
18.11.54,18.11.54,1
18.12.55,18.12.55,1
19.1.56,20.1.57,0.79294163
20.1.57,21.1.58,1
20.2.58,21.7.64,0.59653294
20.3.59,21.2.59,1
20.4.60,_,0
20.5.61,21.4.61,1
20.6.62,21.5.62,0.73205566
