1.1.1,1.1.1,1
2.1.2,2.1.2,1
3.1.3,3.1.3,1
4.1.4,4.1.4,1
4.2.5,4.2.5,1
4.3.6,4.3.6,1
4.4.7,4.4.7,1
4.5.8,4.5.8,1
4.6.9,4.6.9,1
5.1.10,5.1.10,1
6.1.11,6.1.11,1
6.2.12,6.2.12,1
6.3.13,6.3.13,1
6.4.14,6.4.14,1
7.1.15,7.1.15,1
8.1.16,8.1.16,1
8.2.17,8.2.17,1
9.1.18,9.1.18,1
10.1.19,10.1.19,1
11.1.20,11.1.20,1
12.1.21,12.1.21,1
13.1.22,13.1.22,1
14.1.23,14.1.23,1
15.1.24,15.1.24,1
16.1.25,16.1.25,1
17.1.26,17.1.26,1
18.1.27,18.1.27,1
19.1.28,19.1.28,1
19.2.29,19.2.29,1
19.3.30,19.3.30,1
19.4.31,19.4.31,1
19.5.32,19.5.32,1
19.6.33,19.6.33,1
19.7.34,19.7.34,1
