1.1.1,1.1.1,1
2.1.2,2.1.2,1
3.1.3,3.1.3,1
4.1.4,4.1.4,1
5.1.5,5.1.5,1
5.2.6,5.2.6,1
5.3.7,5.3.7,1
6.1.8,6.1.8,1
7.1.9,7.1.9,1
8.1.10,8.1.10,1
8.2.11,8.2.11,1
8.3.12,8.3.12,1
8.4.13,8.4.13,1
8.5.14,8.5.14,1
8.6.15,8.6.15,1
8.7.16,8.7.16,1
9.1.17,9.1.17,1
9.2.18,9.2.18,1
9.3.19,9.3.19,1
9.4.20,9.4.20,1
9.5.21,9.5.21,1
9.6.22,9.6.22,1
10.1.23,10.1.23,1
11.1.24,11.1.24,1
12.1.25,12.1.25,1
13.1.26,13.1.26,1
13.2.27,13.2.27,1
13.3.28,13.3.28,1
13.4.29,13.4.29,1
13.5.30,13.5.30,1
13.6.31,13.6.31,1
13.7.32,13.7.32,1
14.1.33,14.1.33,1
15.1.34,15.1.34,1
15.2.35,15.2.35,1
15.3.36,15.3.36,1
15.4.37,15.4.37,1
15.5.38,15.5.38,1
15.6.39,15.6.39,1
15.7.40,15.7.40,1
16.1.41,16.1.41,1
17.1.42,17.1.42,1
18.1.43,18.1.43,1
18.2.44,18.2.44,1
18.3.45,18.3.45,1
