1.1.1,1.1.1,1
1.2.2,1.2.2,1
1.3.3,1.3.3,1
1.4.4,1.4.4,1
1.5.5,1.5.5,1
2.1.6,2.1.6,1
3.1.7,3.1.7,1
4.1.8,4.1.8,1
5.1.9,5.1.9,1
6.1.10,6.1.10,1
7.1.11,7.1.11,1
7.2.12,7.2.12,1
8.1.13,8.1.13,1
9.1.14,9.1.14,1
9.2.15,9.2.15,1
10.1.16,10.1.16,1
11.1.17,11.1.17,1
11.2.18,11.2.18,1
12.1.19,12.1.19,1
13.1.20,13.1.20,1
13.2.21,13.2.21,1
13.3.22,13.3.22,1
13.4.23,13.4.23,1
13.5.24,13.5.24,1
13.6.25,13.6.25,1
13.7.26,13.7.26,1
14.1.27,14.1.27,1
15.1.28,15.1.28,1
