_,13.1.23,0
1.1.1,1.1.1,1
1.2.2,1.2.2,1
1.3.3,1.3.3,1
1.4.4,1.4.4,1
1.5.5,1.5.5,1
2.1.6,2.1.6,1
3.1.7,3.1.7,1
4.1.8,4.1.8,1
4.2.9,4.2.9,1
5.1.10,5.1.10,0.9822222
6.1.11,6.1.11,1
6.2.12,6.2.12,1
7.1.13,7.1.13,1
7.2.14,7.2.14,1
8.1.15,8.1.15,1
8.2.16,8.2.16,1
9.1.17,9.1.17,1
10.1.18,10.1.18,1
10.2.19,10.2.19,1
11.1.20,11.1.20,1
12.1.21,12.1.21,1
12.2.22,12.2.22,1
13.1.23,14.1.24,1
13.2.24,14.2.25,1
14.1.25,15.1.26,1
14.2.26,15.2.27,1
15.1.27,16.1.28,1
16.1.28,17.1.29,1
16.2.29,17.2.30,1
16.3.30,17.3.31,1
16.4.31,17.4.32,1
16.5.32,17.5.33,1
17.1.33,18.1.34,1
17.2.34,18.2.35,1
17.3.35,18.3.36,1
18.1.36,19.1.37,1
18.2.37,19.2.38,1
19.1.38,20.1.39,1
19.2.39,20.2.40,1
