_,3.1.7,0
1.1.1,1.1.1,1
1.2.2,1.2.2,1
1.3.3,1.3.3,1
1.4.4,1.4.4,1
1.5.5,1.5.5,1
2.1.6,2.1.6,1
3.1.7,4.1.8,1
3.2.8,4.2.9,1
4.1.9,5.1.10,1
4.2.10,5.2.11,1
4.3.11,5.3.12,1
4.4.12,5.4.13,1
4.5.13,5.5.14,1
4.6.14,5.6.15,1
4.7.15,5.7.16,1
5.1.16,6.1.17,1
5.2.17,6.2.18,1
5.3.18,6.3.19,1
5.4.19,6.4.20,0.94117653
5.5.20,6.5.21,1
6.1.21,7.1.22,1
6.2.22,7.2.23,1
6.3.23,7.3.24,1
7.1.24,8.1.25,1
8.1.25,9.1.26,1
9.1.26,10.1.27,1
9.2.27,10.2.28,1
10.1.28,11.1.29,1
10.2.29,11.2.30,1
10.3.30,11.3.31,1
11.1.31,12.1.32,1
11.2.32,12.2.33,1
11.3.33,12.3.34,1
11.4.34,12.4.35,1
11.5.35,12.5.36,1
11.6.36,12.6.37,1
11.7.37,12.7.38,1
11.8.38,12.8.39,1
11.9.39,12.9.40,1
11.10.40,12.10.41,1
12.1.41,13.1.42,1
12.2.42,13.2.43,1
12.3.43,13.3.44,1
12.4.44,13.4.45,1
12.5.45,13.5.46,1
13.1.46,14.1.47,1
13.2.47,14.2.48,1
13.3.48,14.3.49,1
14.1.49,15.1.50,1
