1.1.1,1.1.1,1
2.1.2,2.1.2,1
3.1.3,3.1.3,1
4.1.4,4.1.4,1
5.1.5,5.1.5,1
6.1.6,6.1.6,1
7.1.7,7.1.7,1
7.2.8,7.2.8,1
7.3.9,7.3.9,1
8.1.10,8.1.10,1
9.1.11,9.1.11,1
9.2.12,9.2.12,0.9760001
10.1.13,10.1.13,1
11.1.14,11.1.14,1
12.1.15,12.1.15,1
12.2.16,12.2.16,1
12.3.17,12.3.17,1
13.1.18,13.1.18,1
14.1.19,14.1.19,1
14.2.20,14.2.20,1
14.3.21,14.3.21,1
14.4.22,14.4.22,1
15.1.23,15.1.23,1
15.2.24,15.2.24,1
16.1.25,16.1.25,1
17.1.26,17.1.26,1
18.1.27,18.1.27,1
