1.1.1,1.1.1,1
1.2.2,1.2.2,1
1.3.3,1.3.3,1
1.4.4,1.4.4,1
1.5.5,1.5.5,1
2.1.6,2.1.6,1
3.1.7,3.1.7,1
4.1.8,4.1.8,1
5.1.9,5.1.9,1
6.1.10,6.1.10,1
6.2.11,6.2.11,1
6.3.12,6.3.12,1
6.4.13,6.4.13,1
6.5.14,6.5.14,1
7.1.15,7.1.15,1
8.1.16,8.1.16,1
8.2.17,8.2.17,1
9.1.18,9.1.18,1
10.1.19,10.1.19,1
11.1.20,11.1.20,1
11.2.21,11.2.21,1
11.3.22,11.3.22,1
11.4.23,11.4.23,1
11.5.24,11.5.24,1
11.6.25,11.6.25,1
11.7.26,11.7.26,1
11.8.27,11.8.27,1
11.9.28,11.9.28,1
12.1.29,12.1.29,0.9763547
13.1.30,13.1.30,1
13.2.31,13.2.31,1
13.3.32,13.3.32,1
13.4.33,13.4.33,1
13.5.34,13.5.34,0.9739131
14.1.35,14.1.35,1
15.1.36,15.1.36,1
15.2.37,15.2.37,1
15.3.38,15.3.38,1
