_,6.1.17,0
_,6.2.18,0
_,6.5.21,0
_,6.6.22,0
_,7.1.23,0
_,7.2.24,0
_,7.3.25,0
_,8.1.26,0
1.1.1,1.1.1,1
1.2.2,1.2.2,1
1.3.3,1.3.3,1
1.4.4,1.4.4,1
1.5.5,1.5.5,1
2.1.6,2.1.6,1
3.1.7,3.1.7,1
4.1.8,4.1.8,1
4.2.9,4.2.9,1
5.1.10,5.1.10,1
5.2.11,5.2.11,1
5.3.12,5.3.12,1
5.4.13,5.4.13,1
5.5.14,5.5.14,1
5.6.15,5.6.15,1
5.7.16,5.7.16,1
6.1.17,9.1.27,0.5393394
6.2.18,6.3.19,0.7275267
6.3.19,_,0
6.4.20,6.4.20,0.55488956
6.5.21,9.2.28,1
7.1.22,10.1.29,1
7.2.23,10.2.30,1
7.3.24,10.3.31,1
8.1.25,11.1.32,1
9.1.26,12.1.33,1
10.1.27,13.1.34,1
10.2.28,13.2.35,1
11.1.29,14.1.36,1
11.2.30,14.2.37,1
11.3.31,14.3.38,1
12.1.32,15.1.39,1
12.2.33,15.2.40,1
12.3.34,15.3.41,1
12.4.35,15.4.42,1
12.5.36,15.5.43,1
12.6.37,15.6.44,1
12.7.38,15.7.45,1
12.8.39,15.8.46,1
12.9.40,15.9.47,1
12.10.41,15.10.48,1
13.1.42,16.1.49,1
13.2.43,16.2.50,1
13.3.44,16.3.51,1
13.4.45,16.4.52,1
13.5.46,16.5.53,1
14.1.47,17.1.54,1
14.2.48,17.2.55,1
14.3.49,17.3.56,1
15.1.50,18.1.57,1
