1.1.1,1.1.1,1
2.1.2,2.1.2,1
3.1.3,3.1.3,1
4.1.4,4.1.4,1
5.1.5,5.1.5,1
5.2.6,5.2.6,1
6.1.7,6.1.7,1
6.2.8,6.2.8,1
6.3.9,6.3.9,1
7.1.10,7.1.10,1
7.2.11,7.2.11,1
8.1.12,8.1.12,1
9.1.13,9.1.13,1
9.2.14,9.2.14,1
10.1.15,10.1.15,1
11.1.16,11.1.16,1
12.1.17,12.1.17,1
13.1.18,13.1.18,1
13.2.19,13.2.19,1
14.1.20,14.1.20,1
14.2.21,14.2.21,1
14.3.22,14.3.22,1
15.1.23,15.1.23,1
15.2.24,15.2.24,0.9666667
16.1.25,16.1.25,1
16.2.26,16.2.26,1
16.3.27,16.3.27,1
17.1.28,17.1.28,1
17.2.29,17.2.29,1
