_,2.1.6,0
_,3.1.7,0
_,4.1.8,0
_,5.1.9,0
_,6.1.10,0
_,8.1.17,0
_,10.1.19,0
_,12.1.22,0
_,13.1.23,0
_,14.1.24,0
_,15.1.25,0
_,18.1.34,0
_,19.1.35,0
_,23.1.45,0
_,24.1.46,0
_,25.1.47,0
_,28.1.56,0
1.1.1,1.1.1,1
1.2.2,1.2.2,1
1.3.3,1.3.3,1
1.4.4,1.4.4,1
1.5.5,1.5.5,1
2.1.6,_,0
3.1.7,_,0
3.2.8,_,0
3.3.9,_,0
4.1.10,_,0
5.1.11,7.1.11,1
5.2.12,7.2.12,0.74708366
5.3.13,7.3.13,1
5.4.14,7.4.14,1
5.5.15,7.5.15,1
5.6.16,7.6.16,1
6.1.17,9.1.18,1
7.1.18,_,0
8.1.19,11.1.20,1
8.2.20,11.2.21,1
9.1.21,_,0
9.2.22,_,0
10.1.23,_,0
11.1.24,_,0
12.1.25,16.1.26,1
12.2.26,16.2.27,1
12.3.27,16.3.28,1
13.1.28,17.1.29,1
13.2.29,17.2.30,1
13.3.30,17.3.31,1
13.4.31,17.4.32,1
13.5.32,17.5.33,1
14.1.33,20.1.36,0.7003403
15.1.34,21.1.37,1
15.2.35,21.2.38,1
15.3.36,21.3.39,1
16.1.37,22.1.40,1
16.2.38,22.2.41,1
16.3.39,22.3.42,1
16.4.40,22.4.43,1
16.5.41,22.5.44,1
17.1.42,_,0
18.1.43,26.1.48,1
18.2.44,26.2.49,1
18.3.45,26.3.50,1
19.1.46,27.1.51,1
19.2.47,27.2.52,1
19.3.48,27.3.53,1
19.4.49,27.4.54,1
19.5.50,27.5.55,1
