_,1.1.1,0
1.1.1,_,0
1.2.2,_,0
1.3.3,_,0
1.4.4,_,0
1.5.5,_,0
2.1.6,2.1.2,1
3.1.7,3.1.3,1
4.1.8,4.1.4,1
5.1.9,5.1.5,1
6.1.10,6.1.6,1
6.2.11,6.2.7,1
6.3.12,6.3.8,1
6.4.13,6.4.9,1
6.5.14,6.5.10,1
7.1.15,7.1.11,1
8.1.16,8.1.12,1
8.2.17,8.2.13,1
9.1.18,9.1.14,1
10.1.19,10.1.15,1
11.1.20,11.1.16,1
11.2.21,11.2.17,1
11.3.22,11.3.18,1
11.4.23,11.4.19,1
11.5.24,11.5.20,1
11.6.25,11.6.21,1
11.7.26,11.7.22,1
11.8.27,11.8.23,1
11.9.28,11.9.24,1
12.1.29,12.1.25,1
13.1.30,13.1.26,1
13.2.31,13.2.27,1
13.3.32,13.3.28,1
13.4.33,13.4.29,1
13.5.34,13.5.30,1
14.1.35,14.1.31,1
15.1.36,15.1.32,1
15.2.37,15.2.33,1
15.3.38,15.3.34,1
