_,18.6.32,0
1.1.1,1.1.1,1
1.2.2,1.2.2,1
1.3.3,1.3.3,1
1.4.4,1.4.4,1
1.5.5,1.5.5,1
2.1.6,2.1.6,1
3.1.7,3.1.7,1
4.1.8,4.1.8,1
5.1.9,5.1.9,1
6.1.10,6.1.10,1
7.1.11,7.1.11,1
8.1.12,8.1.12,1
8.2.13,8.2.13,1
9.1.14,9.1.14,1
10.1.15,10.1.15,1
10.2.16,10.2.16,1
10.3.17,10.3.17,1
10.4.18,10.4.18,1
10.5.19,10.5.19,1
11.1.20,11.1.20,1
12.1.21,12.1.21,1
13.1.22,13.1.22,1
14.1.23,14.1.23,1
15.1.24,15.1.24,1
16.1.25,16.1.25,1
17.1.26,17.1.26,1
18.1.27,18.1.27,1
18.2.28,18.2.28,1
18.3.29,18.3.29,1
18.4.30,18.4.30,1
18.5.31,18.5.31,1
18.6.32,18.7.33,1
18.7.33,18.8.34,1
18.8.34,18.9.35,1
