1.1.1,1.1.1,1
1.2.2,1.2.2,1
1.3.3,1.3.3,1
1.4.4,1.4.4,1
1.5.5,1.5.5,1
2.1.6,2.1.6,1
3.1.7,3.1.7,1
4.1.8,_,0
5.1.9,_,0
6.1.10,4.1.8,1
7.1.11,5.1.9,1
8.1.12,6.1.10,1
8.2.13,6.2.11,1
9.1.14,7.1.12,1
10.1.15,8.1.13,1
10.2.16,8.2.14,1
10.3.17,8.3.15,1
10.4.18,8.4.16,1
10.5.19,8.5.17,1
11.1.20,9.1.18,1
12.1.21,10.1.19,1
12.2.22,10.2.20,1
12.3.23,10.3.21,1
13.1.24,11.1.22,1
14.1.25,12.1.23,1
14.2.26,12.2.24,1
14.3.27,12.3.25,1
15.1.28,13.1.26,1
16.1.29,14.1.27,1
17.1.30,15.1.28,1
17.2.31,15.2.29,1
18.1.32,16.1.30,1
19.1.33,17.1.31,1
19.2.34,17.2.32,1
19.3.35,17.3.33,1
19.4.36,17.4.34,1
19.5.37,17.5.35,1
19.6.38,17.6.36,1
19.7.39,17.7.37,1
19.8.40,17.8.38,1
