1.1.1,1.1.1,1
2.1.2,2.1.2,1
3.1.3,3.1.3,1
4.1.4,4.1.4,1
5.1.5,5.1.5,1
5.2.6,5.2.6,1
5.3.7,5.3.7,1
5.4.8,5.4.8,1
5.5.9,5.5.9,1
5.6.10,5.6.10,1
5.7.11,5.7.11,1
5.8.12,5.8.12,1
6.1.13,6.1.13,1
7.1.14,7.1.14,1
8.1.15,8.1.15,1
9.1.16,9.1.16,1
10.1.17,10.1.17,1
11.1.18,11.1.18,1
12.1.19,12.1.19,1
13.1.20,13.1.20,1
14.1.21,14.1.21,1
15.1.22,15.1.22,1
16.1.23,16.1.23,1
16.2.24,16.2.24,1
16.3.25,16.3.25,1
16.4.26,16.4.26,1
16.5.27,16.5.27,1
16.6.28,16.6.28,1
16.7.29,16.7.29,1
16.8.30,16.8.30,1
17.1.31,17.1.31,1
18.1.32,18.1.32,1
19.1.33,19.1.33,1
20.1.34,20.1.34,1
21.1.35,21.1.35,1
