1.1.1,1.1.1,1
2.1.2,2.1.2,1
3.1.3,3.1.3,1
4.1.4,4.1.4,1
4.2.5,4.2.5,1
4.3.6,4.3.6,1
5.1.7,5.1.7,1
5.2.8,5.2.8,1
6.1.9,6.1.9,1
7.1.10,7.1.10,1
7.2.11,7.2.11,1
7.3.12,7.3.12,1
8.1.13,8.1.13,1
9.1.14,9.1.14,1
10.1.15,10.1.15,1
10.2.16,10.2.16,1
10.3.17,10.3.17,1
11.1.18,11.1.18,1
11.2.19,11.2.19,1
12.1.20,12.1.20,1
12.2.21,12.2.21,1
13.1.22,13.1.22,1
13.2.23,13.2.23,1
13.3.24,13.3.24,1
14.1.25,14.1.25,1
14.2.26,14.2.26,1
