_,17.2.35,0
_,17.4.37,0
_,17.6.39,0
_,17.7.40,0
1.1.1,1.1.1,1
1.2.2,1.2.2,1
1.3.3,1.3.3,1
1.4.4,1.4.4,1
1.5.5,1.5.5,1
2.1.6,2.1.6,1
3.1.7,3.1.7,0.97424245
4.1.8,4.1.8,1
5.1.9,5.1.9,0.9715762
6.1.10,6.1.10,1
7.1.11,7.1.11,0.9191177
8.1.12,8.1.12,1
9.1.13,9.1.13,1
9.2.14,9.2.14,1
9.3.15,9.3.15,1
9.4.16,9.4.16,1
10.1.17,10.1.17,1
10.2.18,10.2.18,1
10.3.19,10.3.19,1
10.4.20,10.4.20,1
10.5.21,10.5.21,1
10.6.22,10.6.22,1
10.7.23,10.7.23,1
10.8.24,10.8.24,1
10.9.25,10.9.25,1
11.1.26,11.1.26,1
12.1.27,12.1.27,1
12.2.28,12.2.28,1
12.3.29,12.3.29,1
13.1.30,13.1.30,1
14.1.31,14.1.31,0.8692125
15.1.32,15.1.32,1
16.1.33,16.1.33,0.8435149
17.1.34,17.1.34,0.8712927
18.1.35,17.3.36,0.67307353
19.1.36,18.1.41,1
19.2.37,18.2.42,1
20.1.38,17.5.38,0.7720282
