1.1.1,1.1.1,1
2.1.2,2.1.2,1
3.1.3,3.1.3,1
4.1.4,4.1.4,1
5.1.5,5.1.5,1
6.1.6,6.1.6,1
7.1.7,7.1.7,1
8.1.8,8.1.8,1
9.1.9,9.1.9,1
10.1.10,10.1.10,1
11.1.11,11.1.11,1
12.1.12,12.1.12,1
13.1.13,13.1.13,1
13.2.14,13.2.14,1
13.3.15,13.3.15,1
14.1.16,14.1.16,1
15.1.17,15.1.17,1
16.1.18,16.1.18,1
