1.1.1,1.1.1,0.9836956
2.1.2,2.1.2,1
3.1.3,3.1.3,1
4.1.4,4.1.4,1
5.1.5,5.1.5,1
6.1.6,6.1.6,1
6.2.7,6.2.7,1
6.3.8,6.3.8,1
6.4.9,6.4.9,1
6.5.10,6.5.10,1
6.6.11,6.6.11,1
7.1.12,7.1.12,1
8.1.13,8.1.13,1
9.1.14,9.1.14,1
10.1.15,10.1.15,1
10.2.16,10.2.16,1
10.3.17,10.3.17,1
11.1.18,11.1.18,1
11.2.19,11.2.19,1
11.3.20,11.3.20,1
11.4.21,11.4.21,1
11.5.22,11.5.22,1
11.6.23,11.6.23,1
11.7.24,11.7.24,1
12.1.25,12.1.25,1
13.1.26,13.1.26,1
14.1.27,14.1.27,1
