1.1.1,1.1.1,0.9836956
2.1.2,2.1.2,1
3.1.3,3.1.3,1
4.1.4,4.1.4,1
5.1.5,5.1.5,1
5.2.6,5.2.6,1
5.3.7,5.3.7,1
5.4.8,5.4.8,1
5.5.9,5.5.9,1
6.1.10,6.1.10,1
7.1.11,7.1.11,1
8.1.12,8.1.12,1
9.1.13,9.1.13,1
9.2.14,9.2.14,1
9.3.15,9.3.15,1
10.1.16,10.1.16,1
11.1.17,11.1.17,1
12.1.18,12.1.18,1
13.1.19,13.1.19,1
14.1.20,14.1.20,1
15.1.21,15.1.21,1
16.1.22,16.1.22,1
16.2.23,16.2.23,1
16.3.24,16.3.24,1
16.4.25,16.4.25,1
16.5.26,16.5.26,1
16.6.27,16.6.27,1
16.7.28,16.7.28,1
17.1.29,17.1.29,1
18.1.30,18.1.30,1
18.2.31,18.2.31,1
18.3.32,18.3.32,1
19.1.33,19.1.33,1
