1.1.1,1.1.1,0.9836956
2.1.2,2.1.2,1
3.1.3,3.1.3,1
4.1.4,4.1.4,1
5.1.5,5.1.5,1
5.2.6,5.2.6,1
5.3.7,5.3.7,1
5.4.8,5.4.8,1
5.5.9,5.5.9,1
6.1.10,6.1.10,1
7.1.11,7.1.11,1
8.1.12,8.1.12,1
9.1.13,9.1.13,1
10.1.14,10.1.14,1
11.1.15,11.1.15,1
12.1.16,12.1.16,1
13.1.17,13.1.17,1
13.2.18,13.2.18,1
13.3.19,13.3.19,1
13.4.20,13.4.20,1
13.5.21,13.5.21,1
13.6.22,13.6.22,1
14.1.23,14.1.23,1
14.2.24,14.2.24,1
14.3.25,14.3.25,1
15.1.26,15.1.26,1
15.2.27,15.2.27,1
15.3.28,15.3.28,1
16.1.29,16.1.29,1
17.1.30,17.1.30,1
