1.1.1,1.1.1,0.9836956
2.1.2,2.1.2,1
3.1.3,3.1.3,1
4.1.4,4.1.4,1
5.1.5,5.1.5,1
5.2.6,5.2.6,1
5.3.7,5.3.7,1
5.4.8,5.4.8,1
5.5.9,5.5.9,1
6.1.10,6.1.10,1
7.1.11,7.1.11,1
8.1.12,8.1.12,1
9.1.13,9.1.13,1
10.1.14,10.1.14,1
11.1.15,11.1.15,1
12.1.16,12.1.16,1
13.1.17,13.1.17,1
14.1.18,14.1.18,1
15.1.19,15.1.19,1
16.1.20,16.1.20,1
17.1.21,17.1.21,1
17.2.22,17.2.22,1
17.3.23,17.3.23,1
17.4.24,17.4.24,1
17.5.25,17.5.25,1
17.6.26,17.6.26,1
18.1.27,18.1.27,1
19.1.28,19.1.28,1
20.1.29,20.1.29,1
21.1.30,21.1.30,1
