1.1.1,1.1.1,1
1.2.2,1.2.2,1
1.3.3,1.3.3,1
1.4.4,1.4.4,1
1.5.5,1.5.5,1
2.1.6,2.1.6,1
3.1.7,3.1.7,1
4.1.8,4.1.8,1
5.1.9,5.1.9,1
6.1.10,6.1.10,1
7.1.11,7.1.11,1
7.2.12,7.2.12,1
8.1.13,8.1.13,1
9.1.14,9.1.14,1
10.1.15,10.1.15,0.9774059
11.1.16,11.1.16,1
12.1.17,12.1.17,1
13.1.18,13.1.18,1
13.2.19,13.2.19,1
13.3.20,13.3.20,1
14.1.21,14.1.21,1
15.1.22,15.1.22,1
16.1.23,16.1.23,1
16.2.24,16.2.24,1
16.3.25,16.3.25,1
17.1.26,17.1.26,1
18.1.27,18.1.27,1
19.1.28,19.1.28,1
19.2.29,19.2.29,1
19.3.30,19.3.30,1
